Let's Play: Ancient Greek Punishment: The Text Adventure
An Interactive Fiction by Pippin Barr
Release 1 / Serial number 190624 / Inform 7 build 6M62 (I6/v6.33 lib 6/12N) SD

Type HELP for help.

The Bank of the River Styx
Here you are on the gritty beach at the edge of the famous River Styx. The water flows sluggishly by.

You can see Charon's ferry and Charon here.

>HELP
This is a work of interactive fiction and tries to follow standard ways of existing in a textual world: 

 To look at where you are type LOOK. 
 To look at something specific type LOOK AT THING or EXAMINE THING. 
 To pick something up type GET THING or TAKE THING. 
 To talk to someone type TALK TO PERSON. 
 To go somewhere type a direction like NORTH or UP.

Generally speaking, look at everything you can and then work out what to do from there.

* * *

Let's Play: Ancient Greek Punishment: The Text Adventure
An Interactive Fiction by Pippin Barr
Release 1 / Serial number 190624 / Inform 7 build 6M62 (I6/v6.33 lib 6/12N) SD

Type HELP for help.

The Bank of the River Styx
Here you are on the gritty beach at the edge of the famous River Styx. The water flows sluggishly by.

You can see Charon's ferry and Charon here.

>I am sisyphus
Bottom of the Hill
A grey, gritty beach meets the edge of the river. A low, bare hill rises gently upward.

You can see a worryingly large boulder here.

* * *

Let's Play: Ancient Greek Punishment: The Text Adventure
An Interactive Fiction by Pippin Barr
Release 1 / Serial number 190624 / Inform 7 build 6M62 (I6/v6.33 lib 6/12N) SD

Type HELP for help.

The Bank of the River Styx
Here you are on the gritty beach at the edge of the famous River Styx. The water flows sluggishly by.

You can see Charon's ferry and Charon here.

>Sisyphus
You utter the magical words and the world seems to shudder on its axis, blurring everything for a moment. When you adjust your vision, your surroundings have changed.

Bottom of the Hill
A grey, gritty beach meets the edge of the river. A low, bare hill rises gently upward.

You can see a worryingly large boulder here.

>up
A Little Way Up the Hill
Just above the beach the grit-sand turns into a packed dirt of the same colour. The occasional sprig of dead grass serves to liven it up.

>x boulder
That really is a lot of rock. At least it looks a bit smaller from up here. You should probably go down and start pushing it up the hill.

>down
Bottom of the Hill
A grey, gritty beach meets the edge of the river. A low, bare hill rises gently upward.

You can see a worryingly large boulder here.

>x boulder
That really is a lot of rock. There is a grey post-it note stuck to the boulder at eye-level.

>read post-it
The note just says

Push me.

The post-it note suddenly tears off the boulder in a gust of wind and loops madly away into the distance.

>push boulder
You furrow your brow and heave the boulder forward.

A Little Way Up the Hill
Just above the beach the grit-sand turns into a packed dirt of the same colour. The occasional sprig of dead grass serves to liven it up.

* * *

>Sisyphus
You utter the magical words and the world seems to shudder on its axis, blurring everything for a moment. When you adjust your vision, your surroundings have changed.

Bottom of the Hill
A grey, gritty beach meets the edge of the river. A low, bare hill rises gently upward.

You can see a worryingly large boulder here.

>x charon
You can't see any such thing.

>i
You are carrying nothing.

>talk to charon
You can't see any such thing.

>open mouth
You open your mouth and neatly catch the small coin that drops out.

* * *

Let's Play: Ancient Greek Punishment: The Text Adventure
An Interactive Fiction by Pippin Barr
Release 1 / Serial number 190624 / Inform 7 build 6M62 (I6/v6.33 lib 6/12N) SD

Type HELP for help.

The Bank of the River Styx
Here you are on the gritty beach at the edge of the famous River Styx. The water flows sluggishly by.

You can see Charon's ferry and Charon here.

>Test iamsisyphus with "open mouth / x clipboard / talk to charon / 1 / pay charon / get into boat".
I only understood you as far as wanting to test that.

I beg your pardon?

>iamsisyphus
That's not a verb I recognise.

* * *

Let's Play: Ancient Greek Punishment: The Text Adventure
An Interactive Fiction by Pippin Barr
Release 1 / Serial number 190624 / Inform 7 build 6M62 (I6/v6.33 lib 6/12N) SD

Type HELP for help.

The Bank of the River Styx
Here you are on the gritty beach at the edge of the famous River Styx. The water flows sluggishly by.

You can see Charon's ferry and Charon here.

>ask charon about boat
You start trying to speak, but there's something in your mouth.

>tell charon my name
I didn't understand that sentence.

>tell charon about death
You start trying to speak, but there's something in your mouth.

>open mouth
You open your mouth and neatly catch the small coin that drops out.

* * *

>tell charon about
I didn't understand that sentence.

>ask charon about life
Charon looks at you coldly. "None of your business."

* * *

Let's Play: Ancient Greek Punishment: The Text Adventure
An Interactive Fiction by Pippin Barr
Release 1 / Serial number 190624 / Inform 7 build 6M62 (I6/v6.33 lib 6/12N) SD

Type HELP for help.

The Bank of the River Styx
Here you are on the gritty beach at the edge of the famous River Styx. The water flows sluggishly by.

You can see Charon's ferry and Charon here.

>ask charon about cowl
Charon frowns and tugs the cowl a little further over his face.

>ask charon about life
Charon looks at you coldly. "None of your business."

>ask charon about death
Charon looks at you coldly. "None of your business."

>ask charon about charon
Charon looks at you coldly. "None of your business."

* * *

Let's Play: Ancient Greek Punishment: The Text Adventure
An Interactive Fiction by Pippin Barr
Release 1 / Serial number 190624 / Inform 7 build 6M62 (I6/v6.33 lib 6/12N) SD

Type HELP for help.

The Bank of the River Styx
Here you are on the gritty beach at the edge of the famous River Styx. The water flows sluggishly by.

You can see Charon's ferry and Charon here.

>ask charon about ferry
Charon sniffs, "And you are?"

>ask charon about the ferry
Charon sniffs, "And you are?"

* * *

>ask charon about ferry
Charon sniffs, "And you are?"

>x ferry
It's Charon's ferry, not totally unlike a small dinghy.  Right now it is pulled up onto the bank of the river, ready to shove off into the river.

* * *

Let's Play: Ancient Greek Punishment: The Text Adventure
An Interactive Fiction by Pippin Barr
Release 1 / Serial number 190624 / Inform 7 build 6M62 (I6/v6.33 lib 6/12N) SD

Type HELP for help.

The Bank of the River Styx
Here you are on the gritty beach at the edge of the famous River Styx. The water flows sluggishly by.

You can see Charon's ferry and Charon here.

>ask charon about his face
There is no reply.

>ask charon about ferry
Charon looks at you coldly. "None of your business."

>ask charon about a ferry
Charon looks at you coldly. "None of your business."

>ask charon about the boat
There is no reply.

* * *

Let's Play: Ancient Greek Punishment: The Text Adventure
An Interactive Fiction by Pippin Barr
Release 1 / Serial number 190624 / Inform 7 build 6M62 (I6/v6.33 lib 6/12N) SD

Type HELP for help.

The Bank of the River Styx
Here you are on the gritty beach at the edge of the famous River Styx. The water flows sluggishly by.

You can see Charon's ferry and Charon here.

>ask charon about the dinghy
Charon looks at you coldly. "None of your business."

>ask charon about his dinghy
Charon looks at you coldly. "None of your business."

>ask charon about my dinghy
Charon looks at you coldly. "None of your business."

* * *

Let's Play: Ancient Greek Punishment: The Text Adventure
An Interactive Fiction by Pippin Barr
Release 1 / Serial number 190624 / Inform 7 build 6M62 (I6/v6.33 lib 6/12N) SD

Type HELP for help.

The Bank of the River Styx
Here you are on the gritty beach at the edge of the famous River Styx. The water flows sluggishly by.

You can see Charon's ferry and Charon here.

>ask charon about the ferry
Charon sniffs, "And you are?"

>ask charon about ferry
Charon looks at you coldly. "None of your business."

>ask charon about baubles
There is no reply.

* * *

Let's Play: Ancient Greek Punishment: The Text Adventure
An Interactive Fiction by Pippin Barr
Release 1 / Serial number 190624 / Inform 7 build 6M62 (I6/v6.33 lib 6/12N) SD

Type HELP for help.

The Bank of the River Styx
Here you are on the gritty beach at the edge of the famous River Styx. The water flows sluggishly by.

You can see Charon's ferry and Charon here.

>bob
That's not a verb I recognise.

* * *

Let's Play: Ancient Greek Punishment: The Text Adventure
An Interactive Fiction by Pippin Barr
Release 1 / Serial number 190624 / Inform 7 build 6M62 (I6/v6.33 lib 6/12N) SD

Type HELP for help.

The Bank of the River Styx
Here you are on the gritty beach at the edge of the famous River Styx. The water flows sluggishly by.

You can see Charon's ferry and Charon here.

>close mouth
It's closed already.

>open mouth
You open your mouth and neatly catch the small coin that drops out.

>open mouth
Let's not. You shouldn't just stand around with your mouth open, you know.

* * *

Let's Play: Ancient Greek Punishment: The Text Adventure
An Interactive Fiction by Pippin Barr
Release 1 / Serial number 190624 / Inform 7 build 6M62 (I6/v6.33 lib 6/12N) SD

Type HELP for help.

The Bank of the River Styx
Here you are on the gritty beach at the edge of the famous River Styx. The water flows sluggishly by.

You can see Charon's ferry and Charon here.

>command charon
That's not a verb I recognise.

>tell charon to go west
I didn't understand that sentence.

>tell charon my name
I didn't understand that sentence.

>tell charon about life
Charon rolls his eyes. "Who are you, exactly?"

>x charon
Charon is leaning against his ferry. His eyes look sourly out from beneath a cowl. He is holding a clipboard.

>x charon's eyes
Unhappy.

>x charon's cowl
You can't see any such thing.

* * *

Let's Play: Ancient Greek Punishment: The Text Adventure
An Interactive Fiction by Pippin Barr
Release 1 / Serial number 190624 / Inform 7 build 6M62 (I6/v6.33 lib 6/12N) SD

Type HELP for help.

The Bank of the River Styx
Here you are on the gritty beach at the edge of the famous River Styx. The water flows sluggishly by.

You can see Charon's ferry and Charon here.

>cut charon
With what?

>cut charon with obol
I only understood you as far as wanting to cut Charon.

>jump
You jump on the spot.

* * *

Let's Play: Ancient Greek Punishment: The Text Adventure
An Interactive Fiction by Pippin Barr
Release 1 / Serial number 190624 / Inform 7 build 6M62 (I6/v6.33 lib 6/12N) SD

Type HELP for help.

The Bank of the River Styx
Here you are on the gritty beach at the edge of the famous River Styx. The water flows sluggishly by.

You can see Charon's ferry and Charon here.

>drink river
It's not a nice river.

>get river
It is neither portable nor potable.

* * *

Let's Play: Ancient Greek Punishment: The Text Adventure
An Interactive Fiction by Pippin Barr
Release 1 / Serial number 190624 / Inform 7 build 6M62 (I6/v6.33 lib 6/12N) SD

Type HELP for help.

The Bank of the River Styx
Here you are on the gritty beach at the edge of the famous River Styx. The water flows sluggishly by.

You can see Charon's ferry and Charon here.

>enter ferry
You haven't paid.

>l
Bank of the River Styx (in Charon's ferry)
Here you are at the famous River Styx. The water flows sluggishly by.

You can see Charon here.

>l ferry
Charon's ferry, not totally unlike a small dinghy, is pulled up onto the bank of the river, ready to shove off into the river.

>n
You can't go that way.

>e
You can't go that way.

* * *

>enter ferry
You haven't paid.

>open
(Charon)
He isn't something you can open.

>open mouth
You open your mouth and neatly catch the small coin that drops out.

>enter ferry
You haven't paid.

>give coin to charon
Charon doesn't seem interested.

>enter ferry
You haven't paid.

>pay charon
You hand over the small coin.

>enter ferry
You get into Charon's ferry.

* * *

>enter ferry
You haven't paid.

>test sisyphus
(Testing.)

>[1] open mouth
You open your mouth and neatly catch the small coin that drops out.

>[2] x clipboard
Charon irritably angles the clipboard away from you, but not before you've seen the list of names he's expecting for the trip across the river:

Sisyphus
Tantalus
Prometheus
Danaids
Zeno

>[3] talk to charon
Before you can get a word in, Charon monotones, "And you are?"

Recalling the list of names on the clipboard, you say:

1) "I'm Sisyphus!"

2) "Never mind..." 
>> [4] 1
Charon raises his eyebrow, "Oh yeah? Sure thing. Give me the coin.". 

He gestures impatiently with a bony hand.

>[5] pay charon
You hand over the small coin.

>[6] get into boat
Charon does not help you step into the ferry.

Charon climbs in after you.

* * *

Let's Play: Ancient Greek Punishment: The Text Adventure
An Interactive Fiction by Pippin Barr
Release 1 / Serial number 190624 / Inform 7 build 6M62 (I6/v6.33 lib 6/12N) SD

Type HELP for help.

The Bank of the River Styx
Here you are on the gritty beach at the edge of the famous River Styx. The water flows sluggishly by.

You can see Charon's ferry and Charon here.

>fill charon
I only understood you as far as wanting to fill.

>fill
You must supply a noun.

>fill me
I only understood you as far as wanting to fill.

>open mouth
You open your mouth and neatly catch the small coin that drops out.

>fill obol
I only understood you as far as wanting to fill.

>put
(on the obol)
You can't wear that!

>my name is danaid
An Arid Beach
A place where you can do stuff.

You can see a basin, a fountain, and a jug here.

>put water in jug
(first taking the fountain water)
You need some kind of receptacle.

>get jug
Taken.

>put water in jug
(first taking the fountain water)
You fill the jug with water.

* * *

Let's Play: Ancient Greek Punishment: The Text Adventure
An Interactive Fiction by Pippin Barr
Release 1 / Serial number 190624 / Inform 7 build 6M62 (I6/v6.33 lib 6/12N) SD

Type HELP for help.

The Bank of the River Styx
Here you are on the gritty beach at the edge of the famous River Styx. The water flows sluggishly by.

You can see Charon's ferry and Charon here.

>garden
That's not a verb I recognise.

>iamsisyphus
That's not a verb I recognise.

>test
>--> The following tests are available:
'test garden'

* * *

Let's Play: Ancient Greek Punishment: The Text Adventure
An Interactive Fiction by Pippin Barr
Release 1 / Serial number 190624 / Inform 7 build 6M62 (I6/v6.33 lib 6/12N) SD

Type HELP for help.

The Bank of the River Styx
Here you are on the gritty beach at the edge of the famous River Styx. The water flows sluggishly by.

You can see Charon's ferry and Charon here.

>get eyes
That seems to be a part of Charon.

>wear cowl
(first taking the cowl)
That seems to belong to Charon.

>get eyes
That seems to be a part of Charon.

* * *

Let's Play: Ancient Greek Punishment: The Text Adventure
An Interactive Fiction by Pippin Barr
Release 1 / Serial number 190624 / Inform 7 build 6M62 (I6/v6.33 lib 6/12N) SD

Type HELP for help.

The Bank of the River Styx
Here you are on the gritty beach at the edge of the famous River Styx. The water flows sluggishly by.

You can see Charon's ferry and Charon here.

>get into ferry
Charon does not help you step into the ferry.

You haven't paid.

* * *

Let's Play: Ancient Greek Punishment: The Text Adventure
An Interactive Fiction by Pippin Barr
Release 1 / Serial number 190624 / Inform 7 build 6M62 (I6/v6.33 lib 6/12N) SD

Type HELP for help.

The Bank of the River Styx
Here you are on the gritty beach at the edge of the famous River Styx. The water flows sluggishly by.

You can see Charon's ferry and Charon here.

>get on ferry
You need to pay Charon before you can get in.

>get off ferry
But you aren't on Charon's ferry at the moment.

>open mouth
You open your mouth and neatly catch the small coin that drops out.

>x board
Charon irritably angles the clipboard away from you, but not before you've seen the list of names he's expecting for the trip across the river:

Sisyphus
Tantalus
Prometheus
Danaids
Zeno

>talk to charon
Before you can get a word in, Charon monotones, "And you are?"

Recalling the list of names on the clipboard, you say:

1) "I'm Sisyphus!"

2) "I'm Tantalus!"

3) "I'm Prometheus!"

4) "I'm a Danaid!"

5) "I'm Zeno!"

6) "Never mind..." 
>

>1
Charon looks at you blankly, "Sure. Pay me.". 

He holds out a bony hand.

>pay
(Charon)
You hand over the small coin. Charon drops it into a pocket and gestures at the ferry. You should probably get in.

>get in ferry
Charon sets about unmooring the ferry.

>get off ferry
But you aren't on Charon's ferry at the moment.

Charon steps deftly into the ferry and takes up his position at the oars.

>get out of ferry
I only understood you as far as wanting to get outside.

>get out
Charon stops you with a look. "There's no undoing down here."

With a series of surprisingly muscular pulls on the oars, Charon sends the ferry across the river. You barely have time to take in the gloomy fog and lack of scenery before the prow of the boat grinds onto the rocky sand of a beach.

Charon looks at you implacably. You intuit that it's time for you to get out.

* * *

>get on ferry
You need to pay Charon before you can get in.

>test sisyphus
(Testing.)

>[1] open mouth
You open your mouth and neatly catch the small coin that drops out.

>[2] x clipboard
Charon irritably angles the clipboard away from you, but not before you've seen the list of names he's expecting for the trip across the river:

Sisyphus
Tantalus
Prometheus
Danaids
Zeno

>[3] talk to charon
Before you can get a word in, Charon monotones, "And you are?"

Recalling the list of names on the clipboard, you say:

1) "I'm Sisyphus!"

2) "I'm Tantalus!"

3) "I'm Prometheus!"

4) "I'm a Danaid!"

5) "I'm Zeno!"

6) "Never mind..." 
>> [4] 1
Charon looks at you blankly, "Sure. Pay me.". 

He holds out a bony hand.

>[5] pay charon
You hand over the small coin. Charon drops it into a pocket and gestures at the ferry. You should probably get in.

>get on ferry
Charon takes pains not to help you step into the ferry, but you make it in alright.

Charon sets about unmooring the ferry.

>get off ferry
You manage to jump out of the ferry clumsily.

Charon stops you with a look. "There's no undoing down here."

Charon steps deftly into the ferry and takes up his position at the oars.

>get off ferry
You manage to jump out of the ferry clumsily.

Charon stops you with a look. "There's no undoing down here."

With a series of surprisingly muscular pulls on the oars, Charon sends the ferry across the river. You barely have time to take in the gloomy fog and lack of scenery before the prow of the boat grinds onto the rocky sand of a beach.

Charon looks at you implacably. You intuit that it's time for you to get out.

>l
Bottom of the Hill (in Charon's ferry)
A grey, gritty beach meets the edge of the river. A low, bare hill rises gently upward.

You can see a worryingly large boulder here.

In Charon's ferry you can see Charon.

>get off
You manage to jump out of the ferry clumsily.

Before he departs, Charon mentions you can get to your punishment faster by just announcing yourself immediately, such as saying "My name is Sisyphus." His duty discharged, Charon oars away without giving you a another thought.

>leave
But you aren't in anything at the moment.

* * *

Let's Play: Ancient Greek Punishment: The Text Adventure
An Interactive Fiction by Pippin Barr
Release 1 / Serial number 190624 / Inform 7 build 6M62 (I6/v6.33 lib 6/12N) SD

Type HELP for help.

The Bank of the River Styx
Here you are on the gritty beach at the edge of the famous River Styx. The water flows sluggishly by.

You can see Charon's ferry and Charon here.

>give obol to charon
You can't see any such thing.

>open mouth
You open your mouth and neatly catch the small coin that drops out.

>give obol to charon
Charon looks at you wearily, "There's nothing to pay for until you tell me who you are."

>tell charon my name
I didn't understand that sentence.

>tell charon about my name
Charon rolls his eyes. "Who are you, exactly?"

* * *

Let's Play: Ancient Greek Punishment: The Text Adventure
An Interactive Fiction by Pippin Barr
Release 1 / Serial number 190624 / Inform 7 build 6M62 (I6/v6.33 lib 6/12N) SD

Type HELP for help.

The Bank of the River Styx
Here you are on the gritty beach at the edge of the famous River Styx. The water flows sluggishly by.

You can see Charon's ferry and Charon here.

>go
You'll have to say which compass direction to go in.

>walk
You'll have to say which compass direction to go in.

* * *

Let's Play: Ancient Greek Punishment: The Text Adventure
An Interactive Fiction by Pippin Barr
Release 1 / Serial number 190624 / Inform 7 build 6M62 (I6/v6.33 lib 6/12N) SD

Type HELP for help.

The Bank of the River Styx
Here you are on the gritty beach at the edge of the famous River Styx. The water flows sluggishly by.

You can see Charon's ferry and Charon here.

>help
This is a work of interactive fiction and tries to follow standard ways of existing in a textual world: 

 To look at where you are type LOOK. 
 To look at something type LOOK AT THING or EXAMINE THING. 
 To pick something up type GET THING or TAKE THING. 
 To talk to someone type TALK TO PERSON. 
 To go somewhere type a compass direction.

Generally speaking, look at everything you can and then work out what to do from there.

>x water
The river seems to sneer at you.

* * *

Let's Play: Ancient Greek Punishment: The Text Adventure
An Interactive Fiction by Pippin Barr
Release 1 / Serial number 190624 / Inform 7 build 6M62 (I6/v6.33 lib 6/12N) SD

Type HELP for help.

The Bank of the River Styx
Here you are on the gritty beach at the edge of the famous River Styx. The water flows sluggishly by.

You can see Charon's ferry and Charon here.

>i
You are carrying nothing.

>x cowl
It's a standard-issue cowl.

>x charon
Charon is leaning against his ferry. His eyes look sourly out from beneath a hoodie. He is holding a clipboard.

* * *

>i
You are carrying nothing.

>x mouth
You purse your lips and can just make them out while staring strenuously downward.

>open mouth
You can't see any such thing.

* * *

>i
You are carrying nothing.

>x obol
A small silver coin imprinted with the blurry image of a sleepy man's face.

* * *

>i
You are carrying nothing.

>x obulus
You can't see any such thing.

* * *

Let's Play: Ancient Greek Punishment: The Text Adventure
An Interactive Fiction by Pippin Barr
Release 1 / Serial number 190624 / Inform 7 build 6M62 (I6/v6.33 lib 6/12N) SD

Type HELP for help.

The Bank of the River Styx
Here you are on the gritty beach at the edge of the famous River Styx. The water flows sluggishly by.

You can see Charon's ferry and Charon here.

>i am prometheus
The Rock (chained to the rock)
Beneath what passes for daylight here, an unpleasantly jagged black rock rises from the ash colored sand of the beach. You are chained to said rock.

>get off
You are tightly chained to the rock, you're not going anywhere. At best you could writhe, struggle, strain, or something like that.

>get onto rock
But you're already on the Rock.

>x rock
It's very black and very rocky. A set of chains are firmly attached to the rock. They also happen to be firmly attaching you to it.

* * *

>i am prometheus
The Rock (chained to the rock)
Beneath what passes for daylight here, an unpleasantly jagged black rock rises from the ash colored sand of the beach. You are chained to said rock.

>l
The Rock (chained to the rock)
Beneath what passes for daylight here, an unpleasantly jagged black rock rises from the ash colored sand of the beach. You are chained to said rock.

An eagle appears on the horizon.

>l
The Rock (chained to the rock)
Beneath what passes for daylight here, an unpleasantly jagged black rock rises from the ash colored sand of the beach. You are chained to said rock.

You can see an eagle here.

The eagle is getting closer.

>l
The Rock (chained to the rock)
Beneath what passes for daylight here, an unpleasantly jagged black rock rises from the ash colored sand of the beach. You are chained to said rock.

You can see an eagle here.

The eagle is nearly at the rock.

>writhe
You writhe in place desperately.

The eagle is disturbed by your wriggling and remains airborne.

>writhe
You writhe in place desperately.

The eagle is disturbed by your wriggling and remains airborne.

>z
Time passes.

The eagle lands heavily beside you.

>writhe
You writhe in place desperately.

The eagle is disturbed by your wriggling and flaps up into the air.

>z
Time passes.

The eagle lands heavily beside you.

>z
Time passes.

The eagle eats some of your liver.

>z
Time passes.

Having eaten your entire liver, the eagle nonchalantly flaps its wings and takes to the air.

>z
Time passes.

The eagle flies off into the distance.

>z
Time passes.

Night falls.

>writhe
You writhe experimentally.

* * *

>i am prometheus
The Rock (chained to the rock)
Beneath what passes for daylight here, an unpleasantly jagged black rock rises from the ash colored sand of the beach. You are chained to said rock.

>n
You are tightly chained to the rock, you're not going anywhere. At best you could writhe, struggle, strain, or something like that.

>s
You are tightly chained to the rock, you're not going anywhere. At best you could writhe, struggle, strain, or something like that.

>e
You are tightly chained to the rock, you're not going anywhere. At best you could writhe, struggle, strain, or something like that.

>w
You are tightly chained to the rock, you're not going anywhere. At best you could writhe, struggle, strain, or something like that.

>up
You are tightly chained to the rock, you're not going anywhere. At best you could writhe, struggle, strain, or something like that.

>down
You are tightly chained to the rock, you're not going anywhere. At best you could writhe, struggle, strain, or something like that.

>restart
Are you sure you want to restart?

>y
Let's Play: Ancient Greek Punishment: The Text Adventure
An Interactive Fiction by Pippin Barr
Release 1 / Serial number 190610 / Inform 7 build 6M62 (I6/v6.33 lib 6/12N) SD

Bank of the River Styx
Here you are at the famous River Styx. The water flows sluggishly by.

You can see Charon's ferry and Charon here.

>n
You can't go that way.

>s
You can't go that way.

* * *

>i am prometheus
The Rock (chained to the rock)
Beneath what passes for daylight here, an unpleasantly jagged black rock rises from the ash colored sand of the beach. You are chained to said rock.

>read note
You can't see any such thing.

>writhe
You writhe experimentally. Nothing obvious happens.

An eagle appears on the horizon.

>writhe
You thrash experimentally. Nothing obvious happens.

The eagle is getting closer.

>writhe
You strain experimentally. Nothing obvious happens.

The eagle is nearly at the rock.

>writhe
You squirm in place desperately. It's enough to disturb the eagle, which flaps up into the air.

>writhe
You struggle in place desperately. It's enough to disturb the eagle, which flaps up into the air.

>struggle
You thrash in place desperately. It's enough to disturb the eagle, which flaps up into the air.

* * *

>i am prometheus
The Rock (chained to the rock)
Beneath what passes for daylight here, an unpleasantly jagged black rock rises from the ash colored sand of the beach. You are chained to said rock.

>s
You can't go that way.

>n
You can't go that way.

* * *

>e
You can't go that way.

>w
You can't go that way.

* * *

>i am prometheus
The Rock (chained to the rock)
Beneath what passes for daylight here, an unpleasantly jagged black rock rises from the ash colored sand of the beach. You are chained to said rock.

>writhe
You writhe in place desperately.

*Writhe*

>jump
You are tightly chained to the rock, you're not going anywhere. At best you could writhe, struggle, strain, or something like that.

>n
You are tightly chained to the rock, you're not going anywhere. At best you could writhe, struggle, strain, or something like that.

>up
You are tightly chained to the rock, you're not going anywhere. At best you could writhe, struggle, strain, or something like that.

* * *

>down
You are tightly chained to the rock, you're not going anywhere. At best you could writhe, struggle, strain, or something like that.

>writhe
You writhe in place desperately.

*Writhe*

>struggle
You writhe in place desperately.

*Writhe*

* * *

>i am prometheus
The Rock (chained to the rock)
Beneath what passes for daylight here, an unpleasantly jagged black rock rises from the ash colored sand of the beach. You are chained to said rock.

>x eagle
You can't see any such thing.

>get up
You are tightly chained to the rock, you're not going anywhere. At best you could writhe, struggle, strain, or something like that.

The eagle is getting closer.

>z
Time passes.

The eagle is getting closer.

>z
Time passes.

The eagle lands heavily on the rock beside you.

>z
Time passes.

The eagle eats some of your liver.

* * *

>z
Time passes.

Having eaten your entire liver, the eagle nonchalantly flaps its wings and takes to the air.

>x liver
You can't see any such thing.

>z
Time passes.

The eagle flies off into the distance.

* * *

>z
Time passes.

Night falls.

>l
The Rock (chained to the rock)
Dimly lit by what might be a moon somewhere behind the fog, an unpleasantly jagged black rock rises from the ash colored sand of the beach. You are chained to said rock.

>x liver
You can't see any such thing.

>kill liver
You can't see any such thing.

>get liver
You can't see any such thing.

>undo
The use of "undo" is forbidden in this story.

>l
The Rock (chained to the rock)
Dimly lit by what might be a moon somewhere behind the fog, an unpleasantly jagged black rock rises from the ash colored sand of the beach. You are chained to said rock.

>x liver
You can't see your liver at the moment.

>l
The Rock (chained to the rock)
Beneath what passes for daylight here, an unpleasantly jagged black rock rises from the ash colored sand of the beach. You are chained to said rock.

* * *

>x eagle
You can't see any such thing.

>z
Time passes.

An eagle appears on the horizon.

>x eagle
It's too far away to see much more than some flapping wings.

The eagle is getting closer.

>x eagle
It's close enough to look quite alarming.

The eagle is nearly at the rock.

>x eagle
It is way too close for comfort.

The eagle lands heavily beside you.

>x eagle
A majestic creature. Terrifying, too It has a determined look in its eye.

The eagle eats some of your liver.

>x eagle
A majestic creature. Terrifying, too It has a determined look in its eye.

The eagle eats some of your liver.

>x eagle
A majestic creature. Terrifying, too It has a determined look in its eye.

Having eaten your entire liver, the eagle nonchalantly flaps its wings and takes to the air.

>x eagle
It looks like an eagle that's eaten a full liver for dinner.

The eagle flies off into the distance.

>x eagle
You can't see any such thing.

* * *

>i am prometheus
The Rock (chained to the rock)
Beneath what passes for daylight here, an unpleasantly jagged black rock rises from the ash colored sand of the beach. You are chained to said rock.

>x river
The rrrriver seems to sneer at you.

An eagle appears on the horizon.

* * *

>i am prometheus
The Rock (chained to the rock)
Beneath what passes for daylight here, an unpleasantly jagged black rock rises from the ash colored sand of the beach. You are chained to said rock.

>x rock
It's very black and very rocky. A set of chains are firmly attached to the rock. They also happen to be firmly attaching you to it.

>n
The only way is up, baby.

* * *

>x rock
It's very black and very rocky. A set of chains are firmly attached to the rock. They also happen to be firmly attaching you to it.

>x chains
Heavy iron chains.

>break chains
You focus your attention on destroying the chains and come out on the losing end.

>attack chains
You focus your attention on destroying the chains and come out on the losing end.

>kill chains
You focus your attention on destroying the chains and come out on the losing end.

>x eagle
He looks quite determined.

* * *

>i am prometheus
The Rock (chained to the rock)
Beneath what passes for daylight here, an unpleasantly jagged black rock rises from the ash colored sand of the beach. You are chained to said rock.

>z
Time passes.

An eagle appears on the horizon.

>l
The Rock (chained to the rock)
Beneath what passes for daylight here, an unpleasantly jagged black rock rises from the ash colored sand of the beach. You are chained to said rock.

You can see an eagle here.

The eagle is getting closer.

* * *

>l
The Rock (chained to the rock)
Beneath what passes for daylight here, an unpleasantly jagged black rock rises from the ash colored sand of the beach. You are chained to said rock.

You can see an eagle here.

The eagle is nearly at the rock.

>l
The Rock (chained to the rock)
Beneath what passes for daylight here, an unpleasantly jagged black rock rises from the ash colored sand of the beach. You are chained to said rock.

You can see an eagle here.

The eagle lands heavily beside you.

>z
Time passes.

The eagle eats some of your liver.

* * *

>z
Time passes.

Night falls.

>z
Time passes.

>z
Time passes.

The night ends surprisingly abruptly. You feel a brisk tingling sensation where your liver was pecked out by the eagle.

>z
Time passes.

An eagle appears on the horizon.

>z
Time passes.

The eagle is getting closer.

>z
Time passes.

The eagle is nearly at the rock.

>z
Time passes.

The eagle lands heavily beside you.

* * *

>z
Time passes.

The eagle eats some of your liver.

>z
Time passes.

The eagle eats some of your liver.

* * *

>z
Time passes.

An eagle appears on the horizon.

>x eagle
Bee bah boo bah

The eagle is getting closer.

>x eagle
Bee bah boo bah

The eagle is nearly at the rock.

>x eagle
Bee bah boo bah

The eagle lands heavily beside you.

* * *

>z
Time passes.

The eagle is getting closer.

>x eagle
It's close enough to look quite alarming.

The eagle is nearly at the rock.

>x
(the eagle)
It is way too close for comfort.

The eagle lands heavily beside you.

>x eagle's eye
That is one cold and uncaring eye.

The eagle eats some of your liver.

>struggle
You strain in place desperately. It's enough to disturb the eagle, which flaps up into the air.

>x eagles eye
You can't see any such thing.

>x eagle's eye
You can't make out the eagle's eye from here.

The eagle lands heavily beside you.

>x eagle's eye
That is one cold and uncaring eye.

The eagle eats some of your liver.

>sneeze
That's not a verb I recognise.

>shout
I didn't understand that sentence.

>scream
That's not a verb I recognise.

>tell the eagle to get off
I didn't understand that sentence.

>tell the eagle about fucking off
This provokes no reaction.

The eagle eats some of your liver.

>kill the eagle
Wrong game.

The eagle eats some of your liver.

>struggle
You writhe in place desperately. It's enough to disturb the eagle, which flaps up into the air.

>w
You are tightly chained to the rock, you're not going anywhere. At best you could writhe, struggle, strain, or something like that.

The eagle lands heavily beside you.

>strain
You writhe in place desperately. It's enough to disturb the eagle, which flaps up into the air.

>z
Time passes.

The eagle lands heavily beside you.

* * *

>z
Time passes.

The eagle eats some of your liver.

>l
The Rock (chained to the rock)
Beneath what passes for daylight here, an unpleasantly jagged black rock rises from the ash colored sand of the beach. You are chained to said rock.

You can see an eagle here.

The eagle eats some of your liver.

>sigh
That's not a verb I recognise.

>wait
Time passes.

The eagle eats some of your liver.

>wait
Time passes.

The eagle eats some of your liver.

>wait
Time passes.

Having eaten your entire liver, the eagle nonchalantly flaps its wings and takes to the air.

>z
Time passes.

The eagle flies off into the distance.

>x liver
You can't see any such thing.

>x eagle
You can't see any such thing.

>z
Time passes.

Night falls.

>x rock
It's very black and very rocky. A set of chains are firmly attached to the rock. They also happen to be firmly attaching you to it.

>sing
That's not a verb I recognise.

>wait
Time passes.

The night ends surprisingly abruptly. You feel a brisk tingling sensation where your liver was pecked out by the eagle.

>x liver
You can't see your liver, your flesh is concealing it in the usual way.

An eagle appears on the horizon.

>x chains
Heavy iron chains.

The eagle is getting closer.

>x chain
Heavy iron chains.

The eagle is nearly at the rock.

>attack chains
You focus your attention on destroying the chains and come out on the losing end.

The eagle lands heavily beside you.

* * *

Let's Play: Ancient Greek Punishment: The Text Adventure
An Interactive Fiction by Pippin Barr
Release 1 / Serial number 190624 / Inform 7 build 6M62 (I6/v6.33 lib 6/12N) SD

Type HELP for help.

The Bank of the River Styx
Here you are on the gritty beach at the edge of the famous River Styx. The water flows sluggishly by.

You can see Charon's ferry and Charon here.

>i am promtheus
I only understood you as far as wanting to take inventory.

>i am prometheus
The Rock (chained to the rock)
Beneath what passes for daylight here, an unpleasantly jagged black rock rises from the ash colored sand of the beach. You are chained to said rock.

>x beach
Apparently death is a beach too.

An eagle appears on the horizon.

* * *

Let's Play: Ancient Greek Punishment: The Text Adventure
An Interactive Fiction by Pippin Barr
Release 1 / Serial number 190624 / Inform 7 build 6M62 (I6/v6.33 lib 6/12N) SD

Type HELP for help.

The Bank of the River Styx
Here you are on the gritty beach at the edge of the famous River Styx. The water flows sluggishly by.

You can see Charon's ferry and Charon here.

>iamsisyphgus
That's not a verb I recognise.

>iamsisyphus
That's not a verb I recognise.

>open mouth
You open your mouth and neatly catch the small coin that drops out.

* * *

Let's Play: Ancient Greek Punishment: The Text Adventure
An Interactive Fiction by Pippin Barr
Release 1 / Serial number 190624 / Inform 7 build 6M62 (I6/v6.33 lib 6/12N) SD

Type HELP for help.

The Bank of the River Styx
Here you are on the gritty beach at the edge of the famous River Styx. The water flows sluggishly by.

You can see Charon's ferry and Charon here.

>iamsisyphus
That's not a verb I recognise.

>iamsisyphus
That's not a verb I recognise.

* * *

Let's Play: Ancient Greek Punishment: The Text Adventure
An Interactive Fiction by Pippin Barr
Release 1 / Serial number 190624 / Inform 7 build 6M62 (I6/v6.33 lib 6/12N) SD

Type HELP for help.

The Bank of the River Styx
Here you are on the gritty beach at the edge of the famous River Styx. The water flows sluggishly by.

You can see Charon's ferry and Charon here.

>insert charon into river
(first taking Charon)
I don't suppose Charon would care for that.

>insert ferry into river
(first taking Charon's ferry)
That's fixed in place.

>open mouth
You open your mouth and neatly catch the small coin that drops out.

>insert coin into river
(the obol into the River Styx)
That can't contain things.

>thrw
That's not a verb I recognise.

>throw
(the obol)
Dropped.

>get obol
Taken.

>throw obol into river
That can't contain things.

* * *

Let's Play: Ancient Greek Punishment: The Text Adventure
An Interactive Fiction by Pippin Barr
Release 1 / Serial number 190624 / Inform 7 build 6M62 (I6/v6.33 lib 6/12N) SD

Type HELP for help.

The Bank of the River Styx
Here you are on the gritty beach at the edge of the famous River Styx. The water flows sluggishly by.

You can see Charon's ferry and Charon here.

>l clipboard
Charon irritably angles the clipboard away from you, but not before you've seen the list of names he's expecting for the trip across the river.

-------
 Sisyphus
 Tantalus
 Prometheus
 Danaids
 Zeno.

-------

>l charon
Charon is leaning against his ferry. His eyes look sourly out from beneath a cowl.

* * *

>l clipboard
Charon irritably angles the clipboard away from you, but not before you've seen the list of names he's expecting for the trip across the river.

-------
 Sisyphus
 Tantalus
 Prometheus
 Danaids
 Zeno.

-------

>x cowl
You can't see any such thing.

>x eyes
You can't see any such thing.

* * *

Let's Play: Ancient Greek Punishment: The Text Adventure
An Interactive Fiction by Pippin Barr
Release 1 / Serial number 190624 / Inform 7 build 6M62 (I6/v6.33 lib 6/12N) SD

Type HELP for help.

The Bank of the River Styx
Here you are on the gritty beach at the edge of the famous River Styx. The water flows sluggishly by.

You can see Charon's ferry and Charon here.

>l ferry
Charon's ferry, not totally unlike a small dinghy, is pulled up onto the bank of the river, ready to shove off into the river.

>enter ferry
You get into Charon's ferry.

>get out
You get out of Charon's ferry.

Bank of the River Styx
You are standing on the bank of the River Styx. The water flows sluggishly by.

You can see Charon here.

>enter ferry
You get into Charon's ferry.

>l
Bank of the River Styx (in Charon's ferry)
You are standing on the bank of the River Styx. The water flows sluggishly by.

You can see Charon here.

>get out
You get out of Charon's ferry.

Bank of the River Styx
You are standing on the bank of the River Styx. The water flows sluggishly by.

You can see Charon here.

>get ferry
That's hardly portable.

* * *

Let's Play: Ancient Greek Punishment: The Text Adventure
An Interactive Fiction by Pippin Barr
Release 1 / Serial number 190624 / Inform 7 build 6M62 (I6/v6.33 lib 6/12N) SD

Type HELP for help.

The Bank of the River Styx
Here you are on the gritty beach at the edge of the famous River Styx. The water flows sluggishly by.

You can see Charon's ferry and Charon here.

>look
Example Location

>w
You can't go that way.

>e
You can't go that way.

>s
You can't go that way.

* * *

Let's Play: Ancient Greek Punishment: The Text Adventure
An Interactive Fiction by Pippin Barr
Release 1 / Serial number 190624 / Inform 7 build 6M62 (I6/v6.33 lib 6/12N) SD

Type HELP for help.

The Bank of the River Styx
Here you are on the gritty beach at the edge of the famous River Styx. The water flows sluggishly by.

You can see Charon's ferry and Charon here.

>look into charon's pocket
Nosy!

>search charon's pocket
Nosy!

* * *

Let's Play: Ancient Greek Punishment: The Text Adventure
An Interactive Fiction by Pippin Barr
Release 1 / Serial number 190624 / Inform 7 build 6M62 (I6/v6.33 lib 6/12N) SD

Type HELP for help.

The Bank of the River Styx
Here you are on the gritty beach at the edge of the famous River Styx. The water flows sluggishly by.

You can see Charon's ferry and Charon here.

>ls clipboard
That's not a verb I recognise.

>l clipboard
You see nothing special about the clipboard.

>l charon
Charon is leaning against his ferry. His eyes look sourly out from beneath a cowl.

>l clipboard
You see nothing special about the clipboard.

* * *

Let's Play: Ancient Greek Punishment: The Text Adventure
An Interactive Fiction by Pippin Barr
Release 1 / Serial number 190624 / Inform 7 build 6M62 (I6/v6.33 lib 6/12N) SD

Type HELP for help.

The Bank of the River Styx
Here you are on the gritty beach at the edge of the famous River Styx. The water flows sluggishly by.

You can see Charon's ferry and Charon here.

>my name is danaid
An Arid Beach
The sand here is bone dry. Rising out of the ground is a fountain and a little distance from it is a basin.

You can see a jug here.

>fill jug
(first taking the jug)
You fill the jug with water.

>i
You are carrying:
  a jug

>x jug
An earthenware jug with a handle. It's filled with water.

>get water
There's already water in the jug.

>empty
That's not a verb I recognise.

>pour water
(first taking the fountain water)
There's already water in the jug.

>pour jug
You unceremoniously pour the jug of water onto the ground.

>pour jug
You tip the empty jug and pour pretend water out of it. It's still empty afterwards.

>get water
You fill the jug with water.

>x jug
An earthenware jug with a handle. It's filled with water.

>x water
Cool, clear water.

* * *

>my name is danaid
An Arid Beach
The sand here is bone dry. Rising out of the ground is a fountain and a little distance from it is a basin.

You can see a jug here.

>get jug
Taken.

>fill jug
You fill the jug with water from the fountain.

>fill basin
(the basin)
You carefully pour the water in the jug into the basin. It streams in nicely, catching what little light there is.

>get water
You fill the jug with water from the fountain.

The water in the basin drains out through several holes, dissapating into the sand.

>pour water into basin
(the basin)
You carefully pour the water in the jug into the basin. It streams in nicely, catching what little light there is.

>x basin
(the basin)
A wide basin intended for holding liquid. Let's say water. It turns out there are holes drilled in the bottom of the basin. There is a note stuck to the rim.

In the basin is some water.

The water in the basin drains out through several holes, dissapating into the sand.

>x basin
(the basin)
A wide basin intended for holding liquid. Let's say water. It turns out there are holes drilled in the bottom of the basin. There is a note stuck to the rim.

>x fountain
(the fountain)
A small fountain perpetually shooting water a short way up into the air before it cascades down into a shallow bowl and drains out.

In the fountain is some water.

>get water
You fill the jug with water from the fountain.

>x fountain
(the fountain)
A small fountain perpetually shooting water a short way up into the air before it cascades down into a shallow bowl and drains out.

* * *

>get jug
Taken.

>get water
You fill the jug with water from the fountain.

>pour water into fountain
You carefully pour the water in the jug into the fountain, thereby achieving slightly less than nothing.

>get water
You fill the jug with water from the fountain.

>fill fountain
(the fountain)
You carefully pour the water in the jug into the fountain, thereby achieving slightly less than nothing.

>x fountain
(the fountain)
A small fountain perpetually shooting water a short way up into the air before it cascades down into a shallow bowl and drains out.

In the fountain is some water.

* * *

>get water
You fill the jug with water from the fountain.

>fill basin
(the basin)
You carefully pour the water in the jug into the basin. It streams in nicely, catching what little light there is.

>x fountain
(the fountain)
A small fountain perpetually shooting water a short way up into the air before it cascades down into a shallow bowl and drains out.

You watch as the water in the basin drains out through several holes, dissapating into the sand.

* * *

>get water
You fill the jug with water from the fountain.

>put water into basin
(the basin)
You carefully pour the water in the jug into the basin. It streams in nicely, catching what little light there is.

>x basin
(the basin)
A wide basin intended for holding liquid. Let's say water. There is a note stuck to its rim.

In the basin is some water.

>get water
You fill the jug with water.

>x jug
An earthenware jug with a handle.

In the jug is some water.

>pour water into basin
I only understood you as far as wanting to pour the water.

* * *

>get jug
Taken.

>pour water into basin
Nah.

>pour jug into basin
Nah.

>pour basin into basin
(the basin into the basin)
Nah.

* * *

>get jug
Taken.

>put jug in fountin
You can't see any such thing.

>put jug in fountain
(the fountain)
You put the jug into the fountain.

>x fountain
(the fountain)
A small fountain perpetually shooting water a short way up into the air before it cascades down into a shallow bowl and drains out.

In the fountain is a jug.

>get jug
Taken.

>put jug in basin
(the basin)
You put the jug into the basin.

>x basin
(the basin)
A wide basin intended for holding liquid. Let's say water. There is a note stuck to the rim.

In the basin is a jug.

>get jug
Taken.

* * *

>fill jug
You fill the jug with water from the fountain.

>x jug
An earthenware jug with a handle. It's filled with water.

>pour water
You unceremoniously pour the jug of water onto the ground.

>x jug
An earthenware jug with a handle.It's empty.

* * *

>my name is danaid
An Arid Beach
The sand here is bone dry. Rising out of the ground is a fountain and a little distance from it is a basin.

You can see a jug here.

>get note
You pluck the note from the basin.

>i
You are carrying:
  a note

>read note
"Fill me.

lol, Zeus"

Just as you finish reading it, the note blows out of your hand on a mysterious gust of wind and vanishes into the distance.

>i
You are carrying:
  an a note

* * *

>read note
"Fill me.

lol, Zeus"

Just as you finish reading it, the note blows out of your hand on a mysterious gust of wind and vanishes into the distance.

>x water
Which do you mean, the River Styx or the fountain water?

>x fountain water
Cool, clear water.

>x fountain
(the fountain)
A small fountain perpetually shooting water a short way up into the air before it cascades down into a shallow bowl and drains out.

>put water in jug
Which do you mean, the River Styx or the fountain water?

>fountain
(first taking the fountain water)
You need some kind of receptacle.

>get jug
Taken.

* * *

>my name is danaid
An Arid Beach
The sand here is bone dry. Rising out of the ground is a fountain and a little distance from it is a basin.

You can see a jug here.

>get water
You need some kind of receptacle.

>fountain
That's not a verb I recognise.

>get jug
Taken.

>get water
You fill the jug with water.

>fountain
That's not a verb I recognise.

>get water
There's already water in the jug.

>fill
That's not a verb I recognise.

* * *

>get water
You need some kind of receptacle.

>get jug
Taken.

>drop jug
Dropped.

>put water in jug
(first taking the water)
You need some kind of receptacle.

>i
You are carrying nothing.

>put water into basin
(the basin)
You don't have any water.

>put water into the basin
(the basin)
You don't have any water.

>get water
You need some kind of receptacle.

* * *

>get jug
Taken.

>put water into the basin
(the basin)
The jug is empty.

>fill jug
You fill the jug with water.

>put water into the basin
(the basin)
You carefully pour the water in the jug into the basin. It streams in nicely, catching what little light there is.

>drop jug
Dropped.

>drink water
Your drinking days are over.

>x basin
(the basin)
A wide basin intended for holding liquid. Let's say water. There is a note stuck to its rim.

In the basin is some water.

* * *

>get jug
Taken.

>empty jug
You tip the empty jug and pour pretend water out of it. It's still empty afterwards.

>fill jug
You fill the jug with water.

>empty jug
You unceremoniously pour the jug of water onto the ground.

>put water into basin
(the basin)
(first taking the water)
You fill the jug with water.

* * *

>get water
You fill the jug with water from the fountain.

>i
You are carrying:
  a jug of water

>put water in jug
(first taking the water)
There's already water in the jug.

That's hardly portable.

>put water in fountain
(the fountain)
(first taking the water)
There's already water in the jug.

That's hardly portable.

* * *

>get water
You fill the jug with water from the fountain.

>pour jug
You unceremoniously pour the jug of water onto the ground.

>l
An Arid Beach
A place where you can do stuff.

You can see a basin and a fountain here.

>l water
Cool, clear water.

>get water
You fill the jug with water.

>pour water
You unceremoniously pour the jug of water onto the ground.

>pour jug
You tip the empty jug and pour pretend water out of it. It's still empty afterwards.

>x fountain
(the fountain)
A small fountain perpetually shooting water a short way up into the air before it cascades down into a shallow bowl and drains out.

In the fountain is some water.

>get water
You fill the jug with water.

>get water
There's already water in the jug.

>pour jug
You unceremoniously pour the jug of water onto the ground.

>fill jug
You fill the jug with water.

>drop jug
Dropped.

>fill jug
(first taking the jug)
There's already water in the jug.

* * *

>get water
You fill the jug with water from the fountain.

>x jug
An earthenware jug with a handle.

In the jug is some water.

>x fountain
(the fountain)
A small fountain perpetually shooting water a short way up into the air before it cascades down into a shallow bowl and drains out.

>pour water
You unceremoniously pour the jug of water onto the ground.

>x fountain
(the fountain)
A small fountain perpetually shooting water a short way up into the air before it cascades down into a shallow bowl and drains out.

In the fountain is some water.

>open fountain
(the fountain)
It isn't something you can open.

>i
You are carrying:
  a jug

>x jug
An earthenware jug with a handle.

>pour water into basin
(the basin)
The jug is empty.

>x basin
(the basin)
A wide basin intended for holding liquid. Let's say water. There is a note stuck to the rim.

>get water
You fill the jug with water from the fountain.

>pour water into basin
(the basin)
You carefully pour the water in the jug into the basin. It streams in nicely, catching what little light there is.

>x basin
(the basin)
A wide basin intended for holding liquid. Let's say water. There is a note stuck to the rim.

In the basin is some water.

The water in the basin drains out through several holes, dissapating into the sand.

>x jug
An earthenware jug with a handle.

>get water
You fill the jug with water from the fountain.

* * *

>x jug
An earthenware jug with a handle.

In the jug is some water.

>pour water
You unceremoniously pour the jug of water onto the ground.

>x jug
An earthenware jug with a handle.

>x basin
(the basin)
A wide basin intended for holding liquid. Let's say water. It turns out there are holes drilled in the bottom of the basin. There is a note stuck to the rim.

* * *

>get water
You need some kind of receptacle.

>i
You are carrying nothing.

>get jug
Taken.

* * *

>get water
You fill the jug with water.

>i
You are carrying:
  a jug of water

>x jug
An earthenware jug with a handle. It's filled with water.

In the jug of water are some water.

>drop water
You haven't got those.

>put water in basin
(first taking the water)
There's already water in the jug.

>get water
There's already water in the jug.

* * *

>my name is danaid
An Arid Beach
The sand here is bone dry. Rising out of the ground is a fountain and a little distance from it is a basin.

You can see a jug here.

>l
An Arid Beach
A place where you can do stuff.

>w
You can't go that way.

* * *

>n
You can't go that way.

>leave
But you aren't in anything at the moment.

>exit
But you aren't in anything at the moment.

>restart
Are you sure you want to restart?

>y
Let's Play: Ancient Greek Punishment: The Text Adventure
An Interactive Fiction by Pippin Barr
Release 1 / Serial number 190612 / Inform 7 build 6M62 (I6/v6.33 lib 6/12N) SD

The Bank of the River Styx
Here you are at the famous River Styx. The water flows sluggishly by.

You can see Charon's ferry and Charon here.

>open mouth
You open your mouth and neatly catch the small coin that drops out.

* * *

>talk to charon
Before you can get a word in, Charon monotones, "And you are?"

Recalling the list of names on the clipboard, you say:

1) "I'm Sisyphus!"

2) "I'm Tantalus!"

3) "I'm Prometheus!"

4) "I'm a Danaid!"

5) "I'm Zeno!"

6) "Never mind..." 
>

>4
Charon looks at you blankly, "Sure. Pay me.". 

He holds out a bony hand.

>pay charon
You hand over the small coin. Charon drops it into a pocket and gestures at the ferry.

>get in
Charon sets about unmooring the ferry.

>z
Time passes.

Charon steps deftly into the ferry and takes up his position at the oars.

>z
Time passes.

With a series of surprisingly muscular pulls on the oars, Charon sends the ferry across the river. You barely have time to take in the gloomy fog and lack of scenery before the prow of the boat grinds onto the rocky sand of a beach.

Charon looks at you implacably. You intuit that it's time for you to get out.

>l
An Arid Beach (in Charon's ferry)
A place where you can do stuff.

In Charon's ferry you can see Charon.

>get out
Before he departs, Charon mentions you can get to your punishment faster by just announcing yourself immediately, such as saying "My name is Danaid." His duty discharged, Charon oars away without giving you a another thought.

>l
An Arid Beach
A place where you can do stuff.

* * *

>my name is danaid
An Arid Beach
The sand here is bone dry. Rising out of the ground is a fountain and a little distance from it is a basin.

You can see a jug here.

>pour water
(first taking the water)
You need some kind of receptacle.

>get jug
Taken.

>pour water
(first taking the water)
You fill the jug with water.

>pour water
(first taking the water)
There's already water in the jug.

>pour jug
(first taking the water)
There's already water in the jug.

>put water in basin
(first taking the water)
There's already water in the jug.

>i
You are carrying:
  a jug of water

* * *

>my name is danaid
An Arid Beach
The sand here is bone dry. Rising out of the ground is a fountain and a little distance from it is a basin.

You can see a jug here.

>pour water into basin
You don't have any water.

>get water
You need some kind of receptacle.

* * *

>get jug
Taken.

>pour water into basin
The jug is empty.

>fill jug
You fill the jug with water.

>pour jug into fountain
That's not something you'll need to do.

>pour jug into basin
That's not something you'll need to do.

* * *

>my name is danaid
An Arid Beach
The sand here is bone dry. Rising out of the ground is a fountain and a little distance from it is a basin.

You can see a jug here.

>pour water into jug
(first taking the fountain water)
You need some kind of receptacle.

>put water into jig
You can't see any such thing.

>put water into jug
(first taking the fountain water)
You need some kind of receptacle.

>get jug
Taken.

* * *

>get water
You fill the jug with water.

>pour jug
You unceremoniously pour the jug of water onto the ground.

>pour water
(first taking the fountain water)
You fill the jug with water.

>pour water
(first taking the fountain water)
There's already water in the jug.

>pour water into basin
(first taking the fountain water)
There's already water in the jug.

* * *

>my name is danaid
An Arid Beach
The sand here is bone dry. Rising out of the ground is a fountain and a little distance from it is a basin.

You can see a jug here.

>pout water into fountain
That's not a verb I recognise.

>pour water into fountain
You don't have any water.

>get jug
Taken.

* * *

>pour water into fountain
You carefully pour the water in the jug into the fountain, thereby achieving slightly less than nothing.

>x fountain
(the fountain)
A small fountain perpetually shooting water a short way up into the air before it cascades down into a shallow bowl and drains out.

In the fountain is some water.

* * *

>get water
You fill the jug with water from the fountain.

>pour water into basin
You carefully pour the water in the jug into the basin. It streams in nicely, catching what little light there is.

>x basin
(the basin)
A wide basin intended for holding liquid. Let's say water. There is a note stuck to its rim.

In the basin is some water.

You watch as the water in the basin drains out through several holes, dissapating into the sand.

>x fountain
(the fountain)
A small fountain perpetually shooting water a short way up into the air before it cascades down into a shallow bowl and drains out.

In the fountain is some water.

* * *

>get water
You fill the jug with water from the fountain.

>fill basin
(the basin)
You pour the water into the basin.

>x fountain
(the fountain)
A small fountain perpetually shooting water a short way up into the air before it cascades down into a shallow bowl and drains out.

>z
Time passes.

>x fountain
(the fountain)
A small fountain perpetually shooting water a short way up into the air before it cascades down into a shallow bowl and drains out.

>x basin
(the basin)
A wide basin intended for holding liquid. Let's say water. There is a note stuck to its rim.

In the basin is some water.

* * *

>my name is danaid
An Arid Beach
The sand here is bone dry. Rising out of the ground is a fountain and a little distance from it is a basin.

You can see a jug here.

>put water in jug
(first taking the fountain water)
You need some kind of receptacle.

>take water
You need some kind of receptacle.

>get jug
Taken.

* * *

>put water in jug
(first taking the fountain water)
You fill the jug with water.

>get water with jug
I only understood you as far as wanting to get the fountain water.

>get water in jug
I only understood you as far as wanting to get the fountain water.

>get water
There's already water in the jug.

* * *

>fill
(the jug)

* * *

>my name is danaid
An Arid Beach
The sand here is bone dry. Rising out of the ground is a fountain and a little distance from it is a basin.

You can see a jug here.

>read note
"Fill me.

lol, Zeus"

Just as you finish reading it, the note blows off the rim of the basin on a mysterious gust of wind and vanishes into the distance.

* * *

>my name is danaid
An Arid Beach
The sand here is bone dry. Rising out of the ground is a fountain and a little distance from it is a basin.

You can see a jug here.

>x basin
(the basin)
A wide basin intended for holding liquid. Let's say water. There is a white post-it note stuck to the rim.

>read note
Fill me.

lol, Zeus

>x fountain
A small fountain perpetually shooting water a short way up into the air before it cascades down into a shallow bowl and drains out.

>x basin
A wide basin intended for holding liquid. There is a note stuck to its rim.

>x bowl
It is etched with images of frowning faces.

>x face
You can't see any such thing.

>x faces
They don't look happy with you. Somehow you know it's you.

>x frowning
They don't look happy with you. Somehow you know it's you.

>x jug
An earthenware jug with a handle.

>x handle
Looks sturdy.

>get jug
Taken.

>x handle
It fits your hand perfectly.

* * *

>x basin
(the basin)
A wide basin intended for holding liquid. Let's say water. There is a white post-it note stuck to the rim.

>x basin
(the basin)
A wide basin intended for holding liquid. Let's say water. There is a note stuck to the rim.

>x holes
A set of neatly drilled holes perforate the lower part of the basin, providing handy drainage of any liquids placed inside it.

>get jug
Taken.

* * *

>fill basin
(the basin)
You carefully pour the water in the jug into the basin. It streams in nicely, catching what little light there is.

>z
Time passes.

The water in the basin drains out through several holes, dissapating into the sand.

>x basin
(the basin)
A wide basin intended for holding liquid. Let's say water. It turns out there are holes drilled in the bottom of the basin. There is a note stuck to the rim.

>get note
Taken.

>x basin
(the basin)
A wide basin intended for holding liquid. Let's say water. It turns out there are holes drilled in the bottom of the basin.

>pour basin into fountain
(the basin into the fountain)
You won't be needing to do that.

>pour water into the river
You won't be needing to do that.

>pour jug into the river
You won't be needing to do that.

>pour water into the river
You won't be needing to do that.

* * *

>x basin
(the basin)
A wide basin intended for holding liquid. Let's say water. There is a white post-it note stuck to the rim.

>x rim
That's a quality rim. There is a white post-it note stuck on it.

On the rim is a white post-it note.

>read note
The note says

Fill me.

Just after you finish reading it, the post-it note blows off the rim of the basin and away into the distance.

>my name is sisyphus
Charon told you that would only work on arrival at his ferry. You're stuck here. If you want to get out so bad you can always restart or quit.

* * *

>x basin
(the basin)
A wide basin intended for holding liquid. Let's say water. There is a white post-it note stuck to the rim.

>x rim of basin
That's a quality rim.

On the rim of the basin is a note.

>get note
Taken.

>i
You are carrying:
  a note

>x basin
(the basin)
A wide basin intended for holding liquid. Let's say water.

>read note
"Fill me.

lol, Zeus"

Just as you finish reading it, the note blows out of your hand on a mysterious gust of wind and vanishes into the distance.

>i
You are carrying nothing.

>x fountain
(the fountain)
A small fountain perpetually shooting water a short way up into the air before it cascades down into a shallow bowl and drains out.

In the fountain is some water.

>get water
You need some kind of receptacle.

* * *

>my name is danaid
An Arid Beach
The sand here is bone dry. Rising out of the ground is a fountain and a little distance from it is a basin.

You can see a jug here.

>x fountain
(the fountain)
A small fountain perpetually shooting water a short way up into the air before it cascades down into a shallow bowl and drains out.

>get water
You need some kind of receptacle.

* * *

>x jug
An earthenware jug with a handle.

In the jug is some water.

>empty jug
That's not a verb I recognise.

>drop jug
Dropped.

>x jug
An earthenware jug with a handle.

In the jug is some water.

>get jug
Taken.

>get water
There's already water in the jug.

>drop water
You haven't got that.

* * *

>get water
You need some kind of receptacle.

>i
You are carrying:
  some water

* * *

>get water
You need some kind of receptacle.

>pour water
(first taking the water)
You need some kind of receptacle.

* * *

>x fountain
(the fountain)
A small fountain perpetually shooting water a short way up into the air before it cascades down into a shallow bowl and drains out.

>x basin
(the basin)
A wide basin intended for holding liquid. Let's say water. There is a note stuck to the rim.

>read note
"Fill me.

lol, Zeus"

Just as you finish reading it, the note blows off the rim of the basin on a mysterious gust of wind and vanishes into the distance.

>x basin
(the basin)
A wide basin intended for holding liquid. Let's say water.

>read note
You can't see any such thing.

>x jug
An earthenware jug with a handle. It's empty.

>fill jug
Maybe you should pick up the jug first.

>get jug
Taken.

>x jug
An earthenware jug with a handle. It's empty.

>x basin
(the basin)
A wide basin intended for holding liquid. Let's say water.

>x fountain
(the fountain)
A small fountain perpetually shooting water a short way up into the air before it cascades down into a shallow bowl and drains out.

>fill jug
You fill the jug with water from the fountain.

>x fountain
(the fountain)
A small fountain perpetually shooting water a short way up into the air before it cascades down into a shallow bowl and drains out.

>x jug
An earthenware jug with a handle. It's filled with water.

>x fountain
(the fountain)
A small fountain perpetually shooting water a short way up into the air before it cascades down into a shallow bowl and drains out.

>x basin
(the basin)
A wide basin intended for holding liquid. Let's say water.

>fill basin
(the basin)
You carefully pour the water in the jug into the basin. It streams in nicely, catching what little light there is.

>x basin
(the basin)
A wide basin intended for holding liquid. About a jug's-worth of water is in it right now.

The water in the basin drains out through several holes, dissapating into the sand.

>x basin
(the basin)
A wide basin intended for holding liquid. Let's say water. There are holes drilled in the bottom.

>x holes
A set of neatly drilled holes perforate the lower part of the basin, providing handy drainage of any liquids placed inside it.

>x fountain
(the fountain)
A small fountain perpetually shooting water a short way up into the air before it cascades down into a shallow bowl and drains out.

>x jug
An earthenware jug with a handle. It's empty.

>fill jug
You fill the jug with water from the fountain.

* * *

>fill basin
(the basin)
You carefully pour the water in the jug into the basin. It streams in nicely, catching what little light there is.

>x jug
An earthenware jug with a handle. It's empty.

The water in the basin drains out through several holes, dissapating into the sand.

* * *

>my name is danaid
An Arid Beach
The sand here is bone dry. Rising out of the ground is a fountain and a little distance from it is a basin.

You can see a jug here.

>x holes
A set of neatly drilled holes perforate the lower part of the basin, providing handy drainage of any liquids places inside it.

* * *

>my name is danaid
An Arid Beach
The sand here is bone dry. Rising out of the ground is a fountain and a little distance from it is a basin.

You can see a jug here.

>x sand
Is this literally crushed up bones?

>listen
You hear nothing unexpected.

>listen to the fountain
(the fountain)
Nothing is forthcoming.

>x ground
Is this literally crushed up bones?

>x bowl
It is etched with images of frowning faces.

>x fountain
(the fountain)
A small fountain perpetually shooting water a short way up into the air before it cascades down into a shallow bowl and drains out.

In the fountain is some water.

* * *

>x sand
Is this literally crushed up bones?

>x basin
(the basin)
A wide basin intended for holding liquid. Let's say water. There is a note stuck to its rim.

>x note
"Fill me.

lol, Zeus"

Just as you finish reading it, the note blows off the rim of the basin on a mysterious gust of wind and vanishes into the distance.

>get jug
Taken.

* * *

>pour jug
You unceremoniously pour the jug of water onto the ground.

>get water
You fill the jug with water.

>fill basin
(the basin)
(first taking the basin)
It's far too heavy.

>fill
(the jug)
There's already water in the jug.

>i
You are carrying:
  a jug

>get fountain
(the fountain)
It's firmly attached.

* * *

Let's Play: Ancient Greek Punishment: The Text Adventure
An Interactive Fiction by Pippin Barr
Release 1 / Serial number 190624 / Inform 7 build 6M62 (I6/v6.33 lib 6/12N) SD

Type HELP for help.

The Bank of the River Styx
Here you are on the gritty beach at the edge of the famous River Styx. The water flows sluggishly by.

You can see Charon's ferry and Charon here.

>my name is danaids
I didn't understand that sentence.

>my name is danaid
An Arid Beach
The sand here is bone dry.

You can see a basin, a fountain, and a jug here.

>fill fountain
(the fountain)
It has plenty of water in it already.

>fill basin
(the basin)
You don't have any water.

>get jug
Taken.

>fill basin
(the basin)
You don't have any water.

>fill jug
You fill the jug with water.

>fill basin
(the basin)
You pour the water into the basin.

>i
You are carrying:
  a jug

>fill jug
nothing

>x basin
(the basin)
A wide basin intended for holding liquid. Let's say water. There is a note stuck to its rim.

In the basin is some water.

>fill basin
(the basin)
You don't have any water.

>x basin
(the basin)
A wide basin intended for holding liquid. Let's say water. There is a note stuck to its rim.

In the basin is some water.

>get water
nothing

>empty jug
You tip the empty jug and pour pretend water out of it. It's still empty afterwards.

* * *

>my name is danaid
An Arid Beach
The sand here is bone dry.

You can see a basin, a fountain, and a jug here.

>get water
You need some kind of receptacle.

* * *

>x jug
An earthenware jug with a handle. It's filled with water.

>drop water
You haven't got that.

>i
You are carrying:
  a jug of water

>drop fountain water
You haven't got that.

>empty jug
That's not a verb I recognise.

>open jug
It isn't something you can open.

>pour jug
That's not a verb I recognise.

* * *

Let's Play: Ancient Greek Punishment: The Text Adventure
An Interactive Fiction by Pippin Barr
Release 1 / Serial number 190624 / Inform 7 build 6M62 (I6/v6.33 lib 6/12N) SD

Type HELP for help.

The Bank of the River Styx
Here you are on the gritty beach at the edge of the famous River Styx. The water flows sluggishly by.

You can see Charon's ferry and Charon here.

>my name is prometheus
The Rock (chained to the rock)
Beneath what passes for daylight here, an unpleasantly jagged black rock rises from the ash colored sand of the beach. You are chained to the rock. There is a grey post-it note stuck just next to your head.

>my name is prometheus
It sure is.

An eagle appears on the horizon.

>my name is zeno
Charon told you that would only work on arrival at his ferry. You're stuck here. If you want to get out so bad you can always restart or quit.

The eagle is getting close.

>quit
Are you sure you want to quit?

* * *

>my name is prometheus
The Rock (chained to the rock)
Beneath what passes for daylight here, an unpleasantly jagged black rock rises from the ash colored sand of the beach. You are chained to the rock. There is a grey post-it note stuck just next to your head.

>x post-it
The note says

Wait.

Just after you finish reading it, the post-it note blows off the rock and away into the distance.

An eagle appears on the horizon.

>read post-it
You can't see any such thing.

>look at eagle
It's too far away to see much more than some flapping wings.

The eagle is getting close.

>look at eagle
It's close enough to look quite alarming.

The eagle is right above you.

>look at eagle
It is way too close for comfort.

The eagle lands heavily beside you. You feel an urge to struggle.

>look at eagle
A majestic creature. Terrifying, too. It has a determined look in its eye.

The eagle eats some of your liver.

>struggle
You strain in place desperately. It's enough to disturb the eagle, which flaps up into the air.

>look at eagle
It looks irritable.

The eagle lands heavily beside you. You feel an urge to writhe.

>writhe
You struggle in place desperately. It's enough to disturb the eagle, which flaps up into the air.

* * *

Let's Play: Ancient Greek Punishment: The Text Adventure
An Interactive Fiction by Pippin Barr
Release 1 / Serial number 190624 / Inform 7 build 6M62 (I6/v6.33 lib 6/12N) SD

Type HELP for help.

The Bank of the River Styx
Here you are on the gritty beach at the edge of the famous River Styx. The water flows sluggishly by.

You can see Charon's ferry and Charon here.

>my name is sisyphus
Bottom of the Hill
A grey, gritty beach meets the edge of the river. A low, bare hill rises gently upward.

You can see a worryingly large boulder here.

>my name is prometheus
Charon told you that would only work on arrival at his ferry. You're stuck here. If you want to get out so bad you can always restart or quit.

* * *

>my name is sisyphus
Bottom of the Hill
A grey, gritty beach meets the edge of the river. A low, bare hill rises gently upward.

You can see a worryingly large boulder here.

>n
You can't go that way.

>up
A Little Way Up the Hill
Just above the beach the grit-sand turns into a packed dirt of the same colour. The occasional sprig of dead grass serves to liven it up.

>go up
Partway Up the Hill
The hill slopes up and down away from you, formidable in its general featurelessness. It looks like you're exactly half-way up. Or down.

>run down
A Little Way Up the Hill
Just above the beach the grit-sand turns into a packed dirt of the same colour. The occasional sprig of dead grass serves to liven it up.

>walk down
Bottom of the Hill
A grey, gritty beach meets the edge of the river. A low, bare hill rises gently upward.

You can see a worryingly large boulder here.

>my name is zeno
Charon told you that would only work on arrival at his ferry. You're stuck here.

>restart
Are you sure you want to restart?

>y
Let's Play: Ancient Greek Punishment: The Text Adventure
An Interactive Fiction by Pippin Barr
Release 1 / Serial number 190611 / Inform 7 build 6M62 (I6/v6.33 lib 6/12N) SD

The Bank of the River Styx
Here you are at the famous River Styx. The water flows sluggishly by.

You can see Charon's ferry and Charon here.

>my name is zeno
A Flat Beach (at the starting line)
The beach extends off into the fog. A straight running track of about 100 meters has been sketched into the sand leading north away from the river with the starting line closest to the water. In the distance at the end of the track, a limp green flag is visible. You are at the start line.

>walk south
You can run in all kinds of directions once you've finished the race. For now focus on getting to the flag, which is north of where you are now.

>walk north
You run furiously and cover half the distance to the flag!

A Flat Beach (on the track)
The beach extends off into the fog. A straight running track of about 100 meters has been sketched into the sand leading north away from the river with the starting line closest to the water. In the distance at the end of the track, a limp green flag is visible. You are at the start line.

>run north
You run furiously and cover half the distance to the flag!

>walk
What do you want to walk?

>walk south
Races are for running!

>restart
Are you sure you want to restart?

* * *

>y
Let's Play: Ancient Greek Punishment: The Text Adventure
An Interactive Fiction by Pippin Barr
Release 1 / Serial number 190611 / Inform 7 build 6M62 (I6/v6.33 lib 6/12N) SD

The Bank of the River Styx
Here you are at the famous River Styx. The water flows sluggishly by.

You can see Charon's ferry and Charon here.

>walk south
You can't go that way.

>my name is sisyphus
Bottom of the Hill
A grey, gritty beach meets the edge of the river. A low, bare hill rises gently upward.

You can see a worryingly large boulder here.

>walk up
A Little Way Up the Hill
Just above the beach the grit-sand turns into a packed dirt of the same colour. The occasional sprig of dead grass serves to liven it up.

>walk
You'll have to say which compass direction to go in.

* * *

>my name is sisyphus
Bottom of the Hill
A grey, gritty beach meets the edge of the river. A low, bare hill rises gently upward.

You can see a worryingly large boulder here.

>push
(the worryingly large boulder)
You furrow your brow and heave the boulder forward.

The post-it note that was attached to the boulder is dislodged and blows away in a sudden gust of wind.

>push
(the worryingly large boulder)
You furrow your brow and heave the boulder forward.

Partway Up the Hill
The hill slopes up and down away from you, formidable in its general featurelessness. It looks like you're exactly half-way up. Or down.

>d
A Little Way Up the Hill
Just above the beach the grit-sand turns into a packed dirt of the same colour. The occasional sprig of dead grass serves to liven it up.

Obeying gravity, the boulder rolls calmly down the hill.

The boulder rolls into view.

>d
Bottom of the Hill
A grey, gritty beach meets the edge of the river. A low, bare hill rises gently upward.

The boulder rolls into view.

The boulder settles ponderously back at its starting position.

>push
(the worryingly large boulder)
You furrow your brow and heave the boulder forward.

A Little Way Up the Hill
Just above the beach the grit-sand turns into a packed dirt of the same colour. The occasional sprig of dead grass serves to liven it up.

>push
(the worryingly large boulder)
You furrow your brow and heave the boulder forward.

Partway Up the Hill
The hill slopes up and down away from you, formidable in its general featurelessness. It looks like you're exactly half-way up. Or down.

>push
(the worryingly large boulder)
You furrow your brow and heave the boulder forward.

A Fair Way Up the Hill
A continuation of this relentless expanse of hillside. There seems to be a small hole in the dirt.

>push
(the worryingly large boulder)
You furrow your brow and heave the boulder forward.

Quite Far Up the Hill
Far enough up the hill to be out of breath if you don't get out much. Like the rest of the hill, this part is made entirely out of dirt.

>push
(the worryingly large boulder)
You furrow your brow and heave the boulder forward.

Nearly the Top of the Hill
It's so barren up here you can't even imagine something growing, and you have a pretty good imagination.

>push
(the worryingly large boulder)
You furrow your brow and heave the boulder forward.

The Top of the Hill
The view is disappointing, with just the river below and everywhere a thick blanket of fog that prevents you seeing far in any direction. The boulder is here at last!

[Your score has gone up by 1 point.]

The boulder slips from your grasp as though it has a mind of its own and starts rolling back down the hill. The rumbling sounds it makes is suspiciously like laughter.

>z
Time passes.

The boulder rolls down the hill.

>z'
That's not a verb I recognise.

>z
Time passes.

The boulder rolls down the hill.

>z
Time passes.

The boulder rolls down the hill.

>z
Time passes.

The boulder rolls down the hill.

Below, you see the boulder settle into place at the bottom of the hill.

>listen
You hear nothing unexpected.

>listen to boulder
It's too far away.

>listen to me
Nothing is forthcoming.

>listen to hill
Nothing is forthcoming.

* * *

>push
(the worryingly large boulder)
You furrow your brow and heave the boulder forward.

A Fair Way Up the Hill
A continuation of this relentless expanse of hillside. There seems to be a small hole in the dirt.

>pus
That's not a verb I recognise.

>push
(the worryingly large boulder)
You furrow your brow and heave the boulder forward.

Quite Far Up the Hill
Far enough up the hill to be out of breath if you don't get out much. Like the rest of the hill, this part is made entirely out of dirt.

>push
(the worryingly large boulder)
You furrow your brow and heave the boulder forward.

Nearly the Top of the Hill
It's so barren up here you can't even imagine something growing, and you have a pretty good imagination.

You can see a note from Zeus here.

>push boulder
You furrow your brow and heave the boulder forward.

The Top of the Hill
The view is disappointing, with just the river below and everywhere a thick blanket of fog that prevents you seeing far in any direction. You should really go get the boulder.

The boulder slips from your grasp as though it has a mind of its own and starts rolling back down the hill.

Below, you see the boulder rolling down the hill.

[Your score has just gone up by one point.]

* * *

>push
(the worryingly large boulder)
You furrow your brow and heave the boulder forward.

Nearly the Top of the Hill
It's so barren up here you can't even imagine something growing, and you have a pretty good imagination.

>push boulder
You furrow your brow and heave the boulder forward.

The Top of the Hill
The view is disappointing, with just the river below and everywhere a thick blanket of fog that prevents you seeing far in any direction. The boulder is here at last!

[Your score has gone up by 1 point.]

The boulder slips from your grasp as though it has a mind of its own and starts rolling back down the hill. The rumbling sounds it makes is suspiciously like laughter.

Below, you see the boulder rolling down the hill.

>l
The Top of the Hill
The view is disappointing, with just the river below and everywhere a thick blanket of fog that prevents you seeing far in any direction. You should really go get the boulder.

Below, you see the boulder rolling down the hill.

* * *

>push
(the worryingly large boulder)
You furrow your brow and heave the boulder forward.

The post-it note that was attached to the boulder is dislodged and blows away in a sudden gust of wind.

>up
Partway Up the Hill
The hill slopes up and down away from you, formidable in its general featurelessness. It looks like you're exactly half-way up. Or down.

The boulder rolls calmly away down the hill.

You see the boulder settle into place at the bottom of the hill.

>u/u/u
That's not a verb I recognise.

>u / u / u
I only understood you as far as wanting to (go) u.

>test "u / u / u"
I only understood you as far as wanting to test that.

>test u / u / u
I only understood you as far as wanting to test that.

* * *

>push
(the worryingly large boulder)
You furrow your brow and heave the boulder forward.

The post-it note that was attached to the boulder is dislodged and blows away in a sudden gust of wind.

>z
Time passes.

Obeying gravity, the boulder rolls calmly down the hill.

Below, you see the boulder settle into place at the bottom of the hill.

>d
Bottom of the Hill
A grey, gritty beach meets the edge of the river. A low, bare hill rises gently upward.

You can see a worryingly large boulder here.

>push
(the worryingly large boulder)
You furrow your brow and heave the boulder forward.

A Little Way Up the Hill
Just above the beach the grit-sand turns into a packed dirt of the same colour. The occasional sprig of dead grass serves to liven it up.

>d
Bottom of the Hill
A grey, gritty beach meets the edge of the river. A low, bare hill rises gently upward.

Obeying gravity, the boulder rolls calmly down the hill.
The boulder rolls into view.

The boulder settles ponderously back at its starting position.

>down
You can't go that way.

>d
You can't go that way.

>push
(the worryingly large boulder)
You furrow your brow and heave the boulder forward.

A Little Way Up the Hill
Just above the beach the grit-sand turns into a packed dirt of the same colour. The occasional sprig of dead grass serves to liven it up.

* * *

>push
(the worryingly large boulder)
You furrow your brow and heave the boulder forward.

Partway Up the Hill
The hill slopes up and down away from you, formidable in its general featurelessness. It looks like you're exactly half-way up. Or down.

>up
A Fair Way Up the Hill
A continuation of this relentless expanse of hillside. There seems to be a small hole in the dirt.

Obeying gravity, the boulder rolls calmly down the hill.

>z
Time passes.

The boulder rolls down the hill.

Below, you see the boulder settle into place at the bottom of the hill.

>z
Time passes.

>push
What do you want to push?

>d
You must name something more substantial.

>d
Partway Up the Hill
The hill slopes up and down away from you, formidable in its general featurelessness. It looks like you're exactly half-way up. Or down.

>d
A Little Way Up the Hill
Just above the beach the grit-sand turns into a packed dirt of the same colour. The occasional sprig of dead grass serves to liven it up.

>d
Bottom of the Hill
A grey, gritty beach meets the edge of the river. A low, bare hill rises gently upward.

You can see a worryingly large boulder here.

* * *

>push
(the worryingly large boulder)
You furrow your brow and heave the boulder forward.

A Little Way Up the Hill
Just above the beach the grit-sand turns into a packed dirt of the same colour. The occasional sprig of dead grass serves to liven it up.

>z
Time passes.

Obeying gravity, the boulder rolls calmly down the hill.

Below, you see the boulder settle into place at the bottom of the hill.

* * *

>push
(the worryingly large boulder)
You furrow your brow and heave the boulder forward.

A Little Way Up the Hill
Just above the beach the grit-sand turns into a packed dirt of the same colour. The occasional sprig of dead grass serves to liven it up.

>push boulder down
For reasons known only to you, you give the boulder a little push downhill.

Obeying gravity, the boulder rolls calmly down the hill.

Below, you see the boulder settle into place at the bottom of the hill.

>down
Bottom of the Hill
A grey, gritty beach meets the edge of the river. A low, bare hill rises gently upward.

You can see a worryingly large boulder here.

>push
(the worryingly large boulder)
You furrow your brow and heave the boulder forward.

A Little Way Up the Hill
Just above the beach the grit-sand turns into a packed dirt of the same colour. The occasional sprig of dead grass serves to liven it up.

>read note
You can't see any such thing.

>z
Time passes.

Obeying gravity, the boulder rolls calmly down the hill.

Below, you see the boulder settle into place at the bottom of the hill.

>down
Bottom of the Hill
A grey, gritty beach meets the edge of the river. A low, bare hill rises gently upward.

You can see a worryingly large boulder here.

* * *

>d
Bottom of the Hill
A grey, gritty beach meets the edge of the river. A low, bare hill rises gently upward.

Obeying gravity, the boulder rolls calmly down the hill.
The boulder rolls into view.

The boulder settles ponderously back at its starting position.

>push
(the worryingly large boulder)
You furrow your brow and heave the boulder forward.

A Little Way Up the Hill
Just above the beach the grit-sand turns into a packed dirt of the same colour. The occasional sprig of dead grass serves to liven it up.

* * *

>push
(the worryingly large boulder)
You furrow your brow and heave the boulder forward.

Partway Up the Hill
The hill slopes up and down away from you, formidable in its general featurelessness. It looks like you're exactly half-way up. Or down.

>d
A Little Way Up the Hill
Just above the beach the grit-sand turns into a packed dirt of the same colour. The occasional sprig of dead grass serves to liven it up.

Obeying gravity, the boulder rolls calmly down the hill.
The boulder rolls into view.

>z
Time passes.

The boulder rolls down the hill.

Below, you see the boulder settle into place at the bottom of the hill.

>down
Bottom of the Hill
A grey, gritty beach meets the edge of the river. A low, bare hill rises gently upward.

You can see a worryingly large boulder here.

* * *

>d
A Little Way Up the Hill
Just above the beach the grit-sand turns into a packed dirt of the same colour. The occasional sprig of dead grass serves to liven it up.

Obeying gravity, the boulder rolls calmly down the hill.
The boulder rolls into view.

>l
A Little Way Up the Hill
Just above the beach the grit-sand turns into a packed dirt of the same colour. The occasional sprig of dead grass serves to liven it up.

You can see a worryingly large boulder here.

The boulder rolls down the hill.

Below, you see the boulder settle into place at the bottom of the hill.

* * *

>push
(the worryingly large boulder)
You furrow your brow and heave the boulder forward.

A Little Way Up the Hill
Just above the beach the grit-sand turns into a packed dirt of the same colour. The occasional sprig of dead grass serves to liven it up.

>z
Time passes.

Obeying gravity, the boulder begins to roll calmly away down the hill.

Below, you see the boulder settle into place at the bottom of the hill.

>d
Bottom of the Hill
A grey, gritty beach meets the edge of the river. A low, bare hill rises gently upward.

You can see a worryingly large boulder here.

* * *

>push
(the worryingly large boulder)
You furrow your brow and heave the boulder forward.

A Little Way Up the Hill
Just above the beach the grit-sand turns into a packed dirt of the same colour. The occasional sprig of dead grass serves to liven it up.

>up
Partway Up the Hill
The hill slopes up and down away from you, formidable in its general featurelessness. It looks like you're exactly half-way up. Or down.

Obeying gravity, the boulder begins to roll calmly away down the hill.

Below, you see the boulder settle into place at the bottom of the hill.

>d
A Little Way Up the Hill
Just above the beach the grit-sand turns into a packed dirt of the same colour. The occasional sprig of dead grass serves to liven it up.

* * *

>push
(the worryingly large boulder)
You furrow your brow and heave the boulder forward.

Partway Up the Hill
The hill slopes up and down away from you, formidable in its general featurelessness. It looks like you're exactly half-way up. Or down.

>up
A Fair Way Up the Hill
A continuation of this relentless expanse of hillside. There seems to be a small hole in the dirt.

Obeying gravity, the boulder begins to roll calmly away down the hill.

Below, you see the boulder rolling down the hill.

>z
Time passes.

Below, you see the boulder settle into place at the bottom of the hill.

>z
Time passes.

>d
Partway Up the Hill
The hill slopes up and down away from you, formidable in its general featurelessness. It looks like you're exactly half-way up. Or down.

* * *

>push
(the worryingly large boulder)
You furrow your brow and heave the boulder forward.

A Little Way Up the Hill
Just above the beach the grit-sand turns into a packed dirt of the same colour. The occasional sprig of dead grass serves to liven it up.

>push boulder down
For reasons known only to you, you give the boulder a little push downhill.

Obeying gravity, the boulder begins to roll calmly away down the hill.

Below, you see the boulder settle into place at the bottom of the hill.

>d
Bottom of the Hill
A grey, gritty beach meets the edge of the river. A low, bare hill rises gently upward.

You can see a worryingly large boulder here.

>d
You can't go that way.

* * *

>push
(the worryingly large boulder)
You furrow your brow and heave the boulder forward.

Nearly the Top of the Hill
It's so barren up here you can't even imagine something growing, and you have a pretty good imagination.

You can see a note from Zeus here.

>push
What do you want to push?

>push boulder
You furrow your brow and heave the boulder forward.

The Top of the Hill
The view is disappointing, with just the river below and everywhere a thick blanket of fog that prevents you seeing far in any direction. You should really go get the boulder.

The boulder slips from your grasp as though it has a mind of its own and starts rolling back down the hill.

Below, you see the boulder rolling down the hill.

[Your score has just gone up by one point.]

* * *

>push
(the worryingly large boulder)
You furrow your brow and heave the boulder forward.

Partway Up the Hill
The hill slopes up and down away from you, formidable in its general featurelessness. It looks like you're exactly half-way up. Or down.

>z
Time passes.

Unsupported, boulder rolls calmly away down the hill.

Below, you see the boulder rolling down the hill.

>z
Time passes.

Below, you see the boulder settle into place at the bottom of the hill.

>d
A Little Way Up the Hill
Just above the beach the grit-sand turns into a packed dirt of the same colour. The occasional sprig of dead grass serves to liven it up.

I beg your pardon?

>d
Bottom of the Hill
A grey, gritty beach meets the edge of the river. A low, bare hill rises gently upward.

You can see a worryingly large boulder here.

>l
Bottom of the Hill
A grey, gritty beach meets the edge of the river. A low, bare hill rises gently upward.

You can see a worryingly large boulder here.

>push
(the worryingly large boulder)
You furrow your brow and heave the boulder forward.

A Little Way Up the Hill
Just above the beach the grit-sand turns into a packed dirt of the same colour. The occasional sprig of dead grass serves to liven it up.

>z
Time passes.

Unsupported, boulder rolls calmly away down the hill.

Below, you see the boulder settle into place at the bottom of the hill.

>down
Bottom of the Hill
A grey, gritty beach meets the edge of the river. A low, bare hill rises gently upward.

You can see a worryingly large boulder here.

* * *

>push
(the worryingly large boulder)
You furrow your brow and heave the boulder forward.

A Little Way Up the Hill
Just above the beach the grit-sand turns into a packed dirt of the same colour. The occasional sprig of dead grass serves to liven it up.

>d
Bottom of the Hill
A grey, gritty beach meets the edge of the river. A low, bare hill rises gently upward.

The boulder rolls into view.
The boulder settles ponderously back at its starting position.

* * *

>my name is sisyphus
Bottom of the Hill
A grey, gritty beach meets the edge of the river. A low, bare hill rises gently upward.

You can see a worryingly large boulder here.

>read post-it
The note just says "Push me."

The post-it note suddenly tears off the boulder in a gust of wind and loops madly away into the distance.

>read note
You can't see any such thing.

* * *

>my name is sisyphus
Bottom of the Hill
A grey, gritty beach meets the edge of the river. A low, bare hill rises gently upward.

You can see a worryingly large boulder here.

>up
A Little Way Up the Hill
Just above the beach the grit-sand turns into a packed dirt of the same colour. The occasional sprig of dead grass serves to liven it up.

>down
Bottom of the Hill
A grey, gritty beach meets the edge of the river. A low, bare hill rises gently upward.

You can see a worryingly large boulder here.

>push
(the worryingly large boulder)
You furrow your brow and heave the boulder forward.

The post-it note that was attached to the boulder is dislodged and blows away in a sudden gust of wind.

>z
Time passes.

Unsupported, boulder rolls calmly away down the hill.

You see the boulder settle into place at the bottom of the hill.

>push
What do you want to push?

>down
You must name something more substantial.

>down
Bottom of the Hill
A grey, gritty beach meets the edge of the river. A low, bare hill rises gently upward.

You can see a worryingly large boulder here.

* * *

>push
(the worryingly large boulder)
You furrow your brow and heave the boulder forward.

A Little Way Up the Hill
Just above the beach the grit-sand turns into a packed dirt of the same colour. The occasional sprig of dead grass serves to liven it up.

>up
Partway Up the Hill
The hill slopes up and down away from you, formidable in its general featurelessness. It looks like you're exactly half-way up. Or down.

You see the boulder settle into place at the bottom of the hill.

* * *

>up
A Little Way Up the Hill
Just above the beach the grit-sand turns into a packed dirt of the same colour. The occasional sprig of dead grass serves to liven it up.

>up
Partway Up the Hill
The hill slopes up and down away from you, formidable in its general featurelessness. It looks like you're exactly half-way up. Or down.

>up
A Fair Way Up the Hill
A continuation of this relentless expanse of hillside. There seems to be a small hole in the dirt.

>up
Quite Far Up the Hill
Far enough up the hill to be out of breath if you don't get out much. Like the rest of the hill, this part is made entirely out of dirt.

>up
Nearly the Top of the Hill
It's so barren up here you can't even imagine something growing, and you have a pretty good imagination.

You can see a note from Zeus here.

>read note
(the note from Zeus)
The note reads:

lol 

-Zeus

>get note
(the note from Zeus)
A sudden gust of wind blows it out of your grasp and away into the distance. The wind sounded weirdly like laughter.

* * *

>up
A Little Way Up the Hill
Just above the beach the grit-sand turns into a packed dirt of the same colour. The occasional sprig of dead grass serves to liven it up.

>x boulder
That really is a lot of rock. At least it looks a bit smaller from up here.

>up
Partway Up the Hill
The hill slopes up and down away from you, formidable in its general featurelessness. It looks like you're exactly half-way up. Or down.

>x boulder
That really is a lot of rock. At least it looks a bit smaller from up here.

>d
A Little Way Up the Hill
Just above the beach the grit-sand turns into a packed dirt of the same colour. The occasional sprig of dead grass serves to liven it up.

* * *

>d
Bottom of the Hill
A grey, gritty beach meets the edge of the river. A low, bare hill rises gently upward.

You can see a worryingly large boulder here.

>x boulder
That really is a lot of rock.There is a post-it note on the boulder.

>push boulder
You furrow your brow and heave the boulder forward.

A Little Way Up the Hill
Just above the beach the grit-sand turns into a packed dirt of the same colour. The occasional sprig of dead grass serves to liven it up.

>d
Bottom of the Hill
A grey, gritty beach meets the edge of the river. A low, bare hill rises gently upward.

The boulder rolls calmly away down the hill.
The boulder rolls into view.

The boulder settles ponderously back at its starting position.

>x boulder
That really is a lot of rock.There is a post-it note on the boulder.

* * *

>my name is sisyphus
Bottom of the Hill
A grey, gritty beach meets the edge of the river. A low, bare hill rises gently upward.

You can see a worryingly large boulder here.

>x boulder
(the worryingly large boulder)
That really is a lot of rock. There is a post-it note stuck to the boulder at eye-level.

>push boulder
(the worryingly large boulder)
You furrow your brow and heave the boulder forward.

The post-it note that was attached to the boulder is dislodged and blows away in a sudden gust of wind.

The boulder rolls calmly away down the hill.
The boulder rolls into view.

The boulder settles ponderously back at its starting position.

>x boulder
That really is a lot of rock. At least it looks a bit smaller from up here.

>d
Bottom of the Hill
A grey, gritty beach meets the edge of the river. A low, bare hill rises gently upward.

You can see a worryingly large boulder here.

>x boulder
That really is a lot of rock.

* * *

>x boulder
(the worryingly large boulder)
That really is a lot of rock. There is a post-it note stuck to the boulder at eye-level.

>read post-it
The note just says "Push me."

The post-it note suddenly tears off the boulder in a gust of wind and loops madly away into the distance.

>x boulder
That really is a lot of rock.

>up
A Little Way Up the Hill
Just above the beach the grit-sand turns into a packed dirt of the same colour. The occasional sprig of dead grass serves to liven it up.

* * *

>x boulder
(the worryingly large boulder)
That really is a lot of rock. There is a post-it note stuck to the boulder at eye-level.

>x note
The note just says "Push me."

* * *

>my name is sisyphus
Bottom of the Hill
A grey, gritty beach meets the edge of the river. A low, bare hill rises gently upward.

You can see a worryingly large boulder here.

>x note
The note just says

Push me.

The post-it note suddenly tears off the boulder in a gust of wind and loops madly away into the distance.

>up
A Little Way Up the Hill
Just above the beach the grit-sand turns into a packed dirt of the same colour. The occasional sprig of dead grass serves to liven it up.

* * *

>up
Nearly the Top of the Hill
It's so barren up here you can't even imagine something growing, and you have a pretty good imagination.

You can see a note from Zeus here.

>read note
The note says

lol

Yours sincerely,
Zeus

* * *

Let's Play: Ancient Greek Punishment: The Text Adventure
An Interactive Fiction by Pippin Barr
Release 1 / Serial number 190624 / Inform 7 build 6M62 (I6/v6.33 lib 6/12N) SD

Type HELP for help.

The Bank of the River Styx
Here you are on the gritty beach at the edge of the famous River Styx. The water flows sluggishly by.

You can see Charon's ferry and Charon here.

>my name is tantalus
A Desolate Beach (in the pool)
An apple tree extends its branches above a clear pool of water set back a little way from the river's edge. A single apple hangs from a single branch.

Your stomach hurts with hunger.

>get post-it
Which do you mean, the red post-it note or the blue post-it note?

>read post-it note
Which do you mean, the red post-it note or the blue post-it note?

>read red
The note says

Eat me.

Just after you finish reading it, the post-it note blows off the apple and away into the distance.

Your stomach gurgles.

>x pool
Crystal clear, eminently drinkable water. There is a blue post-it note floating on the surface.

You're starving.

>read blue note
The note says

Drink me.

After you read it, the post-it note it plucked from the water by a gust of wind and flaps wetly into the distance.

You're parched.

* * *

>my name is tantalus
A Desolate Beach (in the pool)
An apple tree extends its branches above a clear pool of water set back a little way from the river's edge. A single apple hangs from a single branch.

Your stomach hurts with hunger.

>jump
You jump up toward the apple on its branch, but a gust of wind blows it just as far out of reach as always and all you manage to do is make a splash.

You wish you had something to drink.

>get water
Which do you mean, the River Styx or the pool?

>lick
You can't see any such thing.

>l hands
Cold. Dead.

You're feeling thirsty.

>l hand
Cold. Dead.

You wish you had something to eat.

>taste hand
Nothing tastes of anything in Hades.

You wish you had something to eat.

>eat hand
Your eating days are over.

You're feeling thirsty.

>drink hand
Your drinking days are over.

You're feeling hungry.

>restart
Are you sure you want to restart?

* * *

>y
Let's Play: Ancient Greek Punishment: The Text Adventure
An Interactive Fiction by Pippin Barr
Release 1 / Serial number 190611 / Inform 7 build 6M62 (I6/v6.33 lib 6/12N) SD

The Bank of the River Styx
Here you are at the famous River Styx. The water flows sluggishly by.

You can see Charon's ferry and Charon here.

>open mouth
You open your mouth and neatly catch the small coin that drops out.

* * *

>x board
Charon irritably angles the clipboard away from you, but not before you've seen the list of names he's expecting for the trip across the river:

Sisyphus
Tantalus
Prometheus
Danaids
Zeno

>talk to charon
Before you can get a word in, Charon monotones, "And you are?"

Recalling the list of names on the clipboard, you say:

1) "I'm Sisyphus!"

2) "I'm Tantalus!"

3) "I'm Prometheus!"

4) "Never mind..." 
>

>2
Charon looks at you blankly, "Sure. Pay me.". 

He holds out a bony hand.

>pay charon
You hand over the small coin. Charon drops it into a pocket and gestures at the ferry.

* * *

>z
Time passes.

With a series of surprisingly muscular pulls on the oars, Charon sends the ferry across the river. You barely have time to take in the gloomy fog and lack of scenery before the prow of the boat grinds onto the rocky sand of a beach.

Charon looks at you implacably. You intuit that it's time for you to get out.

>l
A Desolate Beach (in Charon's ferry)
An apple tree extends its branches above a clear pool of water set back a little way from the river's edge. A single apple hangs from a single branch.

In Charon's ferry you can see Charon.

>get out
Charon hops out of the ferry behind you and leads to you the pool a little way up the beach. He points and you find yourself wading into the centre of the pool. Satisfied you're in position, Charon turns and walks back to the ferry.

A Desolate Beach (in the pool)
An apple tree extends its branches above a clear pool of water set back a little way from the river's edge. A single apple hangs from a single branch.

You can see Charon's ferry (in which is Charon) here.

You wish you had something to eat.

Before he departs, Charon mentions you can get to your punishment faster by just announcing yourself immediately, such as saying "My name is Tantalus." His duty discharged, Charon oars away without giving you a another thought.

>x charon
You can't see any such thing.

>w
You would have to get out of the pool first.

You're hungry.

>e
You would have to get out of the pool first.

You're feeling really hungry.

>drink pool
You stoop to drink some water, but it recedes as fast as you move toward it until the bottom of the bool is completely dry. On standing, the water rushes back in up to your waist.

You're thirsty.

>l
A Desolate Beach (in the pool)
An apple tree extends its branches above a clear pool of water set back a little way from the river's edge. A single apple hangs from a single branch.

You're thirsty.

>x tree
Gnarly, man.

You're so thirsty.

>x apple
A shiny, delicious apple just begging to be eaten.

You're feeling hungry.

>get apple
You reach up to pluck the apple from its branch, but as you do a gust of wind blows the branch up and away from you. It only resettles when you give up and drop your arm down again.

You're so thirsty.

>jump
You jump up toward the apple on its branch, but a gust of wind blows it just as far out of reach as always and all you manage to do is make a splash.

You wish you had something to drink.

>eat apple
You reach up to pluck the apple from its branch, but as you do a gust of wind blows the branch up and away from you. It only resettles when you give up and drop your arm down again.

You're thirsty.

>push apple
Stop being so pushy!

You're feeling thirsty.

>taste apple
Nothing tastes of anything in Hades.

You wish you had something to eat.

* * *

>my name is tantalus
A Desolate Beach (in the pool)
An apple tree extends its branches above a clear pool of water set back a little way from the river's edge. A single apple hangs from a single branch.

Your stomach hurts with hunger.

>look at apple
A shiny, delicious apple just begging to be eaten. There is a bright red post-it note stuck to the apple.

You need to drink something.

>look at water
Crystal clear, eminently drinkable water.

You're feeling really thirsty.

>the pool
That's not a verb I recognise.

>drink water
You stoop to drink some water, but it recedes as fast as you move toward it until the bottom of the bool is completely dry. On standing, the water rushes back in up to your waist.

You need to drink.

>the pool
That's not a verb I recognise.

>drink pool
You stoop to drink some water, but it recedes as fast as you move toward it until the bottom of the bool is completely dry. On standing, the water rushes back in up to your waist.

You're hungry.

* * *

>look at apple
A shiny, delicious apple just begging to be eaten. There is a bright red post-it note stuck to the apple.

You need to drink something.

>read post-it
The note says

Eat me.

Just after you finish reading it, the post-it note blows off the apple and away into the distance.

You need to eat something.

* * *

>my name is tantalus
A Desolate Beach (in the pool)
An apple tree extends its branches above a clear pool of water set back a little way from the river's edge. A single apple hangs from a single branch.

Your stomach hurts with hunger.

>w
You would have to get out of the pool first.

>get out
Somehow that's not an option.

>n
You would have to get out of the pool first.

>w
You would have to get out of the pool first.

>e
You would have to get out of the pool first.

>s
You would have to get out of the pool first.

>get out of the pool
I only understood you as far as wanting to get outside.

>get out of pool
I only understood you as far as wanting to get outside.

>get out
Somehow that's not an option.

>leave
Somehow that's not an option.

>x apple
Such a ripe apple for such a sickly tree.

>x water
(the pool)
Crystal clear, eminently drinkable water.

>x river
The river seems to sneer at you.

>drink water
(the pool)
You stoop to drink some water, but it recedes as fast as you move toward it until the bottom of the bool is completely dry. On standing, the water rushes back in up to your waist.

>get apple
You reach up to pluck the apply from its branch, but as you do a gust of wind blows the branch up and away from you. It only resettles when you give up and drop your arm down again.

>l
A Desolate Beach (in the pool)
A gnarled tree extends its branches above a clear pool of water set back a little way from the river's edge. A single apple hangs from a single branch.

>get apple
You reach up to pluck the apply from its branch, but as you do a gust of wind blows the branch up and away from you. It only resettles when you give up and drop your arm down again.

>eat apple
You reach up to pluck the apply from its branch, but as you do a gust of wind blows the branch up and away from you. It only resettles when you give up and drop your arm down again.

>x apple
Such a ripe apple for such a sickly tree.

* * *

Let's Play: Ancient Greek Punishment: The Text Adventure
An Interactive Fiction by Pippin Barr
Release 1 / Serial number 190624 / Inform 7 build 6M62 (I6/v6.33 lib 6/12N) SD

Type HELP for help.

The Bank of the River Styx
Here you are on the gritty beach at the edge of the famous River Styx. The water flows sluggishly by.

You can see Charon's ferry and Charon here.

>my name is zeno
A Flat Beach (at the starting line)
The beach extends off into the fog. A straight track of about 100 meters has been sketched into the sand leading north away from the river with the starting line closest to the water. You can see a green flag in the distance at the end of the track. You are at the start line.

>get off
The best way to get off the starting line would be to run north down the track.

>n
You run furiously and cover half the distance to the flag!

A Flat Beach (on the track)
The beach extends off into the fog. A straight running track of about 100 meters has been sketched into the sand leading north away from the river with the starting line closest to the water. In the distance at the end of the track, a limp green flag is visible. You are half-way to the flag.

>get off
You can leave when you've finished the race.

>get out
You can leave when you've finished the race.

>run
You'll have to say which compass direction to go in.

* * *

>my name is zeno
A Flat Beach (at the starting line)
The beach extends off into the fog. A straight track of about 100 meters has been sketched into the sand leading north away from the river with the starting line closest to the water. You can see a green flag in the distance at the end of the track. You are at the start line.

>l
A Flat Beach (at the starting line)
The beach extends off into the fog. A straight running track of about 100 meters has been sketched into the sand leading north away from the river with the starting line closest to the water. In the distance at the end of the track, a limp green flag is visible. You are at the start line.

>run
You'll have to say which compass direction to go in.

>run forward
You can't see any such thing.

>run north
You run furiously and cover half the distance to the flag!

A Flat Beach (on the track)
The beach extends off into the fog. A straight running track of about 100 meters has been sketched into the sand leading north away from the river with the starting line closest to the water. In the distance at the end of the track, a limp green flag is visible. You are at the start line.

*** Run-time problem P10: Since the north is not allowed the property "runs", it is against the rules to try to use it.

0 >0

* * *

>my name is zeno
A Flat Beach (at the starting line)
The beach extends off into the fog. A straight track of about 100 meters has been sketched into the sand leading north away from the river with the starting line closest to the water. You can see a green flag in the distance at the end of the track. You are at the start line.

>look at flag
A green triangle of fabric attached to a pole jammed into the sand at the northern end of the track. It flaps gentle in the wind, making a sound not unlike Archimedes's laughter.

>listen to flag
That guy, eh?

* * *

>my name is zeno
A Flat Beach (at the starting line)
The beach extends off into the fog. A straight track of about 100 meters has been sketched into the sand leading north away from the river with the starting line closest to the water. You can see a green flag in the distance at the end of the track. You are at the start line.

>n
You run furiously and cover half the distance to the flag!

A Flat Beach (on the track)
The beach extends off into the fog. A straight running track of about 100 meters has been sketched into the sand leading north away from the river with the starting line closest to the water. In the distance at the end of the track, a limp green flag is visible. You are at the start line.

>n
You run furiously and cover half the distance to the flag!

>l
A Flat Beach (on the track)
The beach extends off into the fog. A straight running track of about 100 meters has been sketched into the sand leading north away from the river with the starting line closest to the water. In the distance at the end of the track, a limp green flag is visible. You are three-quarters of the way to the flag.

>n
You run furiously and cover half the distance to the flag!

>l
A Flat Beach (on the track)
The beach extends off into the fog. A straight running track of about 100 meters has been sketched into the sand leading north away from the river with the starting line closest to the water. In the distance at the end of the track, a limp green flag is visible. You are seven-eighths of the way to the flag.

>n
You run furiously and cover half the distance to the flag!

>l
A Flat Beach (on the track)
The beach extends off into the fog. A straight running track of about 100 meters has been sketched into the sand leading north away from the river with the starting line closest to the water. In the distance at the end of the track, a limp green flag is visible. You are fifteen-sixteenths of the way to the flag.

>n
You run furiously and cover half the distance to the flag!

>l
A Flat Beach (on the track)
The beach extends off into the fog. A straight running track of about 100 meters has been sketched into the sand leading north away from the river with the starting line closest to the water. In the distance at the end of the track, a limp green flag is visible. You are thirty-one thirty-seconds of the way to the flag.

>n
You run furiously and cover half the distance to the flag!

>l
A Flat Beach (on the track)
The beach extends off into the fog. A straight running track of about 100 meters has been sketched into the sand leading north away from the river with the starting line closest to the water. In the distance at the end of the track, a limp green flag is visible. You are sixty-three sixty-fourths of the way to the flag.

>n
You run furiously and cover half the distance to the flag!

>l
A Flat Beach (on the track)
The beach extends off into the fog. A straight running track of about 100 meters has been sketched into the sand leading north away from the river with the starting line closest to the water. In the distance at the end of the track, a limp green flag is visible. You are a hundred and twenty-seven hundred and twenty-eighths of the way to the flag.

>n
You run furiously and cover half the distance to the flag!

>l
A Flat Beach (on the track)
The beach extends off into the fog. A straight running track of about 100 meters has been sketched into the sand leading north away from the river with the starting line closest to the water. In the distance at the end of the track, a limp green flag is visible. You are extremely close to the flag, You are so close the flag you can taste it, You are practically standing on the flag, but not quite, You have very nearly finished the race, You are incredibly close to finishing the race.

>walk
You'll have to say which compass direction to go in.

* * *

>n
You run furiously and cover half the distance to the flag!

>n
Boo too!!

>n
Boo too!!

>l
A Flat Beach (on the track)
The beach extends off into the fog. A straight running track of about 100 meters has been sketched into the sand leading away from the river with the starting line closest to the water. In the distance at the end of the track, a limp green flag is visible.

>s
You can run in all kinds of directions once you've finished for the race. For now focus on getting to the flag, which is north of where you are now.

>w
You can run in all kinds of directions once you've finished for the race. For now focus on getting to the flag, which is north of where you are now.

>e
You can run in all kinds of directions once you've finished for the race. For now focus on getting to the flag, which is north of where you are now.

>s
You can run in all kinds of directions once you've finished for the race. For now focus on getting to the flag, which is north of where you are now.

>l
A Flat Beach (on the track)
The beach extends off into the fog. A straight running track of about 100 meters has been sketched into the sand leading away from the river with the starting line closest to the water. In the distance at the end of the track, a limp green flag is visible.

* * *

>my name is zeno
A Flat Beach (at the starting line)
The beach extends off into the fog. A straight track of about 100 meters has been sketched into the sand leading north away from the river with the starting line closest to the water. You can see a green flag in the distance at the end of the track. You are at the start line.

>run
You'll have to say which compass direction to go in.

>north
You run furiously and cover half the distance to the flag!

A Flat Beach (on the track)
The beach extends off into the fog. A straight track of about 100 meters has been sketched into the sand leading north away from the river with the starting line closest to the water. In the distance at the end of the track, a limp green flag is visible. You are half-way to the flag.

>north
You run furiously and cover half the distance to the flag!

A Flat Beach (on the track)
The beach extends off into the fog. A straight track of about 100 meters has been sketched into the sand leading north away from the river with the starting line closest to the water. In the distance at the end of the track, a limp green flag is visible. You are three-quarters of the way to the flag.

>north
You run furiously and cover half the distance to the flag!

A Flat Beach (on the track)
The beach extends off into the fog. A straight track of about 100 meters has been sketched into the sand leading north away from the river with the starting line closest to the water. In the distance at the end of the track, a limp green flag is visible. You are seven-eighths of the way to the flag.

>north
You run furiously and cover half the distance to the flag!

A Flat Beach (on the track)
The beach extends off into the fog. A straight track of about 100 meters has been sketched into the sand leading north away from the river with the starting line closest to the water. In the distance at the end of the track, a limp green flag is visible. You are fifteen-sixteenths of the way to the flag.

>north
You run furiously and cover half the distance to the flag!

A Flat Beach (on the track)
The beach extends off into the fog. A straight track of about 100 meters has been sketched into the sand leading north away from the river with the starting line closest to the water. In the distance at the end of the track, a limp green flag is visible. You are thirty-one thirty-seconds of the way to the flag.

>north
You run furiously and cover half the distance to the flag!

A Flat Beach (on the track)
The beach extends off into the fog. A straight track of about 100 meters has been sketched into the sand leading north away from the river with the starting line closest to the water. In the distance at the end of the track, a limp green flag is visible. You are sixty-three sixty-fourths of the way to the flag.

>north
You run furiously and cover half the distance to the flag!

A Flat Beach (on the track)
The beach extends off into the fog. A straight track of about 100 meters has been sketched into the sand leading north away from the river with the starting line closest to the water. In the distance at the end of the track, a limp green flag is visible. You are a hundred and twenty-seven hundred and twenty-eighths of the way to the flag.

>north
You run furiously and cover half the distance to the flag!

A Flat Beach (on the track)
The beach extends off into the fog. A straight track of about 100 meters has been sketched into the sand leading north away from the river with the starting line closest to the water. In the distance at the end of the track, a limp green flag is visible. You are a two hundred and fifty-five two hundred and fifty-sixths of the way to the flag.

* * *

>run
You'll have to say which compass direction to go in.

>run
You'll have to say which compass direction to go in.

>n
You run furiously and cover half the distance to the flag!

A Flat Beach (on the track)
The beach extends off into the fog. A straight track of about 100 meters has been sketched into the sand leading north away from the river with the starting line closest to the water. In the distance at the end of the track, a limp green flag is visible. You are half-way to the flag.

>n
You run furiously and cover half the distance to the flag!

A Flat Beach (on the track)
The beach extends off into the fog. A straight track of about 100 meters has been sketched into the sand leading north away from the river with the starting line closest to the water. In the distance at the end of the track, a limp green flag is visible. You are three-quarters of the way to the flag.

>n
You run furiously and cover half the distance to the flag!

A Flat Beach (on the track)
The beach extends off into the fog. A straight track of about 100 meters has been sketched into the sand leading north away from the river with the starting line closest to the water. In the distance at the end of the track, a limp green flag is visible. You are seven-eighths of the way to the flag.

>n
You run furiously and cover half the distance to the flag!

A Flat Beach (on the track)
The beach extends off into the fog. A straight track of about 100 meters has been sketched into the sand leading north away from the river with the starting line closest to the water. In the distance at the end of the track, a limp green flag is visible. You are fifteen-sixteenths of the way to the flag.

>n
You run furiously and cover half the distance to the flag!

A Flat Beach (on the track)
The beach extends off into the fog. A straight track of about 100 meters has been sketched into the sand leading north away from the river with the starting line closest to the water. In the distance at the end of the track, a limp green flag is visible. You are thirty-one thirty-seconds of the way to the flag.

>n
You run furiously and cover half the distance to the flag!

A Flat Beach (on the track)
The beach extends off into the fog. A straight track of about 100 meters has been sketched into the sand leading north away from the river with the starting line closest to the water. In the distance at the end of the track, a limp green flag is visible. You are sixty-three sixty-fourths of the way to the flag.

>n
You run furiously and cover half the distance to the flag!

A Flat Beach (on the track)
The beach extends off into the fog. A straight track of about 100 meters has been sketched into the sand leading north away from the river with the starting line closest to the water. In the distance at the end of the track, a limp green flag is visible. You are a hundred and twenty-seven hundred and twenty-eighths of the way to the flag.

>n
You run furiously and cover half the distance to the flag!

A Flat Beach (on the track)
The beach extends off into the fog. A straight track of about 100 meters has been sketched into the sand leading north away from the river with the starting line closest to the water. In the distance at the end of the track, a limp green flag is visible. You are a two hundred and fifty-five two hundred and fifty-sixths of the way to the flag.

>n
You run furiously and cover half the distance to the flag!

A Flat Beach (on the track)
The beach extends off into the fog. A straight track of about 100 meters has been sketched into the sand leading north away from the river with the starting line closest to the water. In the distance at the end of the track, a limp green flag is visible. You are practically standing on the flag, but not quite.

>n
You run furiously and cover half the distance to the flag!

A Flat Beach (on the track)
The beach extends off into the fog. A straight track of about 100 meters has been sketched into the sand leading north away from the river with the starting line closest to the water. In the distance at the end of the track, a limp green flag is visible. You are incredibly close to finishing the race.

>n
You run furiously and cover half the distance to the flag!

A Flat Beach (on the track)
The beach extends off into the fog. A straight track of about 100 meters has been sketched into the sand leading north away from the river with the starting line closest to the water. In the distance at the end of the track, a limp green flag is visible. You are extremely close to the flag.

>n
You run furiously and cover half the distance to the flag!

A Flat Beach (on the track)
The beach extends off into the fog. A straight track of about 100 meters has been sketched into the sand leading north away from the river with the starting line closest to the water. In the distance at the end of the track, a limp green flag is visible. You are extremely close to the flag.

>n
You run furiously and cover half the distance to the flag!

A Flat Beach (on the track)
The beach extends off into the fog. A straight track of about 100 meters has been sketched into the sand leading north away from the river with the starting line closest to the water. In the distance at the end of the track, a limp green flag is visible. You are practically standing on the flag, but not quite.

>n
You run furiously and cover half the distance to the flag!

A Flat Beach (on the track)
The beach extends off into the fog. A straight track of about 100 meters has been sketched into the sand leading north away from the river with the starting line closest to the water. In the distance at the end of the track, a limp green flag is visible. You are so close the flag you can taste it.

>n
You run furiously and cover half the distance to the flag!

A Flat Beach (on the track)
The beach extends off into the fog. A straight track of about 100 meters has been sketched into the sand leading north away from the river with the starting line closest to the water. In the distance at the end of the track, a limp green flag is visible. You are practically standing on the flag, but not quite.

>taste flag
Nothing tastes of anything in Hades.

* * *

>my name is zeno
A Flat Beach (at the starting line)
The beach extends off into the fog. A straight track of about 100 meters has been sketched into the sand leading north away from the river with the starting line closest to the water. You can see a green flag in the distance at the end of the track. You are at the start line.

>run east
Races are for running!

>run north
Races are for running!

* * *

>my name is zeno
A Flat Beach (at the starting line)
The beach extends off into the fog. A straight track of about 100 meters has been sketched into the sand leading north away from the river with the starting line closest to the water. You can see a green flag in the distance at the end of the track. You are at the start line.

>run north
You run furiously and cover half the distance to the flag!

A Flat Beach (on the track)
The beach extends off into the fog. A straight running track of about 100 meters has been sketched into the sand leading north away from the river with the starting line closest to the water. In the distance at the end of the track, a limp green flag is visible. You are half-way to the flag.

>run north
You run furiously and cover half the distance to the flag!

A Flat Beach (on the track)
The beach extends off into the fog. A straight running track of about 100 meters has been sketched into the sand leading north away from the river with the starting line closest to the water. In the distance at the end of the track, a limp green flag is visible. You are three-quarters of the way to the flag.

>run north
You run furiously and cover half the distance to the flag!

A Flat Beach (on the track)
The beach extends off into the fog. A straight running track of about 100 meters has been sketched into the sand leading north away from the river with the starting line closest to the water. In the distance at the end of the track, a limp green flag is visible. You are seven-eighths of the way to the flag.

>run north
You run furiously and cover half the distance to the flag!

A Flat Beach (on the track)
The beach extends off into the fog. A straight running track of about 100 meters has been sketched into the sand leading north away from the river with the starting line closest to the water. In the distance at the end of the track, a limp green flag is visible. You are fifteen-sixteenths of the way to the flag.

>run north
You run furiously and cover half the distance to the flag!

A Flat Beach (on the track)
The beach extends off into the fog. A straight running track of about 100 meters has been sketched into the sand leading north away from the river with the starting line closest to the water. In the distance at the end of the track, a limp green flag is visible. You are thirty-one thirty-seconds of the way to the flag.

>run north
You run furiously and cover half the distance to the flag!

A Flat Beach (on the track)
The beach extends off into the fog. A straight running track of about 100 meters has been sketched into the sand leading north away from the river with the starting line closest to the water. In the distance at the end of the track, a limp green flag is visible. You are sixty-three sixty-fourths of the way to the flag.

>run north
You run furiously and cover half the distance to the flag!

A Flat Beach (on the track)
The beach extends off into the fog. A straight running track of about 100 meters has been sketched into the sand leading north away from the river with the starting line closest to the water. In the distance at the end of the track, a limp green flag is visible. You are a hundred and twenty-seven hundred and twenty-eighths of the way to the flag.

>run north
You run furiously and cover half the distance to the flag!

A Flat Beach (on the track)
The beach extends off into the fog. A straight running track of about 100 meters has been sketched into the sand leading north away from the river with the starting line closest to the water. In the distance at the end of the track, a limp green flag is visible. You have very nearly finished the race.

>run north
You run furiously and cover half the distance to the flag!

A Flat Beach (on the track)
The beach extends off into the fog. A straight running track of about 100 meters has been sketched into the sand leading north away from the river with the starting line closest to the water. In the distance at the end of the track, a limp green flag is visible. You are extremely close to the flag.

>run north
You run furiously and cover half the distance to the flag!

A Flat Beach (on the track)
The beach extends off into the fog. A straight running track of about 100 meters has been sketched into the sand leading north away from the river with the starting line closest to the water. In the distance at the end of the track, a limp green flag is visible. You are so close the flag you can taste it.

>touch flag
You think about reaching for the flag, but you really need to focus on this footrace for now.

>jump
Let's not even think about jumping.

>touch track
You think about reaching for the track, but you really need to focus on this footrace for now.

>touch me
You think about reaching for yourself, but you really need to focus on this footrace for now.

>touch my mouth
You think about reaching for your mouth, but you really need to focus on this footrace for now.

>tuoch my foot
That's not a verb I recognise.

>get flag
You think about reaching for the flag, but you really need to focus on this footrace for now.

>get track
You would have to get off the track first.

>get off track
You get off the track.

A Flat Beach
The beach extends off into the fog. A straight running track of about 100 meters has been sketched into the sand leading north away from the river with the starting line closest to the water. In the distance at the end of the track, a limp green flag is visible. You are practically standing on the flag, but not quite.

>get on track
That's not something you can enter.

>mount track
That's not a verb I recognise.

>get onto track
That's not something you can enter.

* * *

>my name is zeno
A Flat Beach (at the starting line)
The beach extends off into the fog. A straight track of about 100 meters has been sketched into the sand leading north away from the river with the starting line closest to the water. You can see a green flag in the distance at the end of the track. You are at the start line.

>walk
You'll have to say which compass direction to go in.

>walk north
Races are for running!

>walk south
Races are for running!

>run north
Races are for running!

>fuck
That's not a verb I recognise.

>north
You run furiously and cover half the distance to the flag!

A Flat Beach (on the track)
The beach extends off into the fog. A straight running track of about 100 meters has been sketched into the sand leading north away from the river with the starting line closest to the water. In the distance at the end of the track, a limp green flag is visible. You are at the start line.

>walk north
Races are for running!

>go north
Races are for running!

* * *

>my name is zeno
A Flat Beach (at the starting line)
The beach extends off into the fog. A straight track of about 100 meters has been sketched into the sand leading north away from the river with the starting line closest to the water. You can see a green flag in the distance at the end of the track. You are at the start line.

>x flag
A muted green triangle of fabric attached to a pole jammed into the sand at the end of the track.

>touch flag
No touching!

>n
(first getting off the starting line)
You can't go that way.

>l
A Flat Beach
The beach extends off into the fog. A straight running track of about 100 meters has been sketched into the sand leading away from the river with the starting line closest to the water. In the distance at the end of the track, a limp green flag is visible.

* * *

>my name is zeno
A Flat Beach (at the starting line)
The beach extends off into the fog. A straight track of about 100 meters has been sketched into the sand leading north away from the river with the starting line closest to the water. You can see a green flag in the distance at the end of the track. You are at the start line.

>x starting line
A line drawn in the sand. A green post-it note rests on the sand near the line.

>read note
The note says

Fill me.

Just after you finish reading it, a gust of wind blows the post-it note along the beach and cartwheeling into the distance.

>x starting line
A line drawn in the sand.

>run
You'll have to say which compass direction to go in.

* * *

>north
You run furiously and cover half the distance to the flag!

A Flat Beach (on the track)
The beach extends off into the fog. A straight track of about 100 meters has been sketched into the sand leading north away from the river with the starting line closest to the water. In the distance at the end of the track, a limp green flag is visible. You are three-quarters of the way to the flag.

>run south
That would be very counterproductive. The finish line is to the north of where you are now.

>touch me
You think about reaching for yourself, but you really need to focus on this sprint for now.

>touch flag
You think about reaching for the flag, but you really need to focus on this sprint for now.

>touch river
You think about reaching for the River Styx, but you really need to focus on this sprint for now.

>touch sand
You can't see any such thing.

>x sand
You can't see any such thing.

>x beach
You can't see any such thing.

* * *

Let's Play: Ancient Greek Punishment: The Text Adventure
An Interactive Fiction by Pippin Barr
Release 1 / Serial number 190624 / Inform 7 build 6M62 (I6/v6.33 lib 6/12N) SD

Type HELP for help.

The Bank of the River Styx
Here you are on the gritty beach at the edge of the famous River Styx. The water flows sluggishly by.

You can see Charon's ferry and Charon here.

>n
You can't go that way.

>i am prometheus
The Rock
A unpleasantly jagged black rock rises from the ash colored sand of the beach.

>n
You can't go that way.

>s
The only way is up, baby.

>i am promtheus
I only understood you as far as wanting to take inventory.

>i am sisyphus
Charon told you that would only work on arrival at his ferry. You're stuck here.

>i am prometheus
Charon told you that would only work on arrival at his ferry. You're stuck here.

* * *

Let's Play: Ancient Greek Punishment: The Text Adventure
An Interactive Fiction by Pippin Barr
Release 1 / Serial number 190624 / Inform 7 build 6M62 (I6/v6.33 lib 6/12N) SD

Type HELP for help.

The Bank of the River Styx
Here you are on the gritty beach at the edge of the famous River Styx. The water flows sluggishly by.

You can see Charon's ferry and Charon here.

>open mouth
You open your mouth and neatly catch the small coin that drops out.

>i
You are carrying:
  an obol

* * *

>open mouth
You open your mouth and neatly catch the small coin that drops out.

>look at clipboard
Charon irritably angles the clipboard away from you, but not before you've seen the list of names he's expecting for the trip across the river:

Sisyphus
Tantalus
Prometheus
Danaids
Zeno

>talk to charon
Before you can get a word in, Charon monotones, "And you are?"

Recalling the list of names on the clipboard, you say:

1) "I'm Sisyphus!"

2) "I'm Tantalus!"

3) "I'm Prometheus!"

4) "I'm a Danaid!"

5) "I'm Zeno!"

6) "Never mind..." 
>

* * *

>1
Charon looks at you blankly, "Sure. Pay me.". 

He holds out a bony hand.

>pay charon
You hand over the small coin. Charon drops it into a pocket and gestures at the ferry. You should probably get in.

>get in
Charon sets about unmooring the ferry.

>get out
Charon stops you with a look. "There's no undoing down here."

Charon steps deftly into the ferry and takes up his position at the oars.

>get out
Charon stops you with a look. "There's no undoing down here."

With a series of surprisingly muscular pulls on the oars, Charon sends the ferry across the river. You barely have time to take in the gloomy fog and lack of scenery before the prow of the boat grinds onto the rocky sand of a beach.

Charon looks at you implacably. You intuit that it's time for you to get out.

>n
You're still in the ferry. You should get out first.

>get ferry
Good one.

>get out
Before he departs, Charon mentions you can get to your punishment faster by just announcing yourself immediately, such as saying "My name is Sisyphus." His duty discharged, Charon oars away without giving you a another thought.

>get ferry
You can't see any such thing.

>restart
Are you sure you want to restart?

>y
Let's Play: Ancient Greek Punishment: The Text Adventure
An Interactive Fiction by Pippin Barr
Release 1 / Serial number 190619 / Inform 7 build 6M62 (I6/v6.33 lib 6/12N) SD

The Bank of the River Styx
Here you are at the famous River Styx. The water flows sluggishly by.

You can see Charon's ferry and Charon here.

>get ferry
Good one.

>get oars
Charon throws you a look that very clearly communicates "do not take those oars."

>get charon
I don't suppose Charon would care for that.

>get clipboard
That seems to belong to Charon.

>get river
That's hardly portable.

* * *

>open mouth
You open your mouth and neatly catch the small coin that drops out.

>open mouth
It's open already, and you've never looked better.

>close mouth
Good idea.

>open mouth
Let's not. You shouldn't just stand around with your mouth open, you know.

>close mouth
It's closed already.

* * *

>open mouth
You open your mouth and neatly catch the small coin that drops out.

>pay charon
You hand over the small coin.

>x charon
Charon is leaning against his ferry. His eyes look sourly out from beneath a cowl. He is holding a clipboard.

>x coin
A small silver coin imprinted with the blurry image of a sleepy man's face.

* * *

>open mouth
You open your mouth and neatly catch the small coin that drops out.

>show obol to charon
Charon nods, "That's the stuff."

>pay charon
Charon looks at you wearily, "There's nothing to pay for until you tell me who you are." (Maybe you should talk to him first?)

>attack charon
Violence isn't the answer to this one.

>attack obol
Violence isn't the answer to this one.

>kill obol
Violence isn't the answer to this one.

>wave to charon
You can't see any such thing.

>wave at charon
You can't see any such thing.

>wave
You wave.

>pull charon
Charon might not like that.

>pull obol
Nothing obvious happens.

>squeeze obol
You achieve nothing by this.

>squeeze charon
Charon might not like that.

>burn charon
This dangerous act would achieve little.

>wake up
The dreadful truth is, this is not a dream.

>think
What a good idea.

>listen to charon
You hear nothing unexpected.

>listen to obol
You hear nothing unexpected.

>cut obol
Cutting it up would achieve little.

* * *

>open mouth
You open your mouth and neatly catch the small coin that drops out.

>talk to charon
Charon looks at you gloomily.

You say:

1) "Uh, hi..."

2) "Never mind..." 
>

>1
Charon sighs. "And you are...?".

1) "Uh, bye..." 
>

>1
Charon smirks.

>look at clipboard
Charon irritably angles the clipboard away from you, but not before you've seen the list of names he's expecting for the trip across the river:

Sisyphus
Tantalus
Prometheus
Danaids
Zeno

* * *

>1
Charon smirks.

>x clipboard
Charon irritably angles the clipboard away from you, but not before you've seen the list of names he's expecting for the trip across the river:

Sisyphus
Tantalus
Prometheus
Danaids
Zeno

>talk to Charon
Charon looks at you gloomily.

1) "Uh, bye..." 
>

* * *

>talk to charon
Charon looks at you gloomily.

You say:

1) "Uh, hi..."

2) "Never mind..." 
>

>2
You shrug, "Never mind..."

Charon smirks.

>talk to charon
Charon looks at you gloomily.

You say:

1) "Uh, hi..."

2) "Never mind..." 
>

>1
Avoiding eye contact, you say "Uh, hi..."

Charon sighs. "And you are...?"

You say:

1) Never mind...

>

>1
Error: no text for No Name.

* * *

>x board
Charon irritably angles the clipboard away from you, but not before you've seen the list of names he's expecting for the trip across the river:

Sisyphus
Tantalus
Prometheus
Danaids
Zeno

>talk charon
I didn't understand that sentence.

>talk to charon
Before you can get a word in, Charon monotones, "And you are?"

Recalling the list of names on the clipboard, you say:

1) "I'm Sisyphus!"

2) "Never mind..." 
>

>1
Charon looks at you blankly, "Sure. Pay me.". 

He holds out a bony hand.

>pay charon
You hand over the small coin. Charon drops it into a pocket and gestures at the ferry.

* * *

>get in
Charon sets about unmooring the ferry.

>get into boat
But you're already in Charon's ferry.

Charon steps deftly into the ferry and takes up his position at the oars.

>z
Time passes.

With a series of surprisingly muscular pulls on the oars, Charon sends the ferry across the river. You barely have time to take in the gloomy fog and lack of scenery before the prow of the boat grinds onto the rocky sand of a beach.

Charon looks at you implacably. You intuit that it's time for you to get out.

>get out
You get out of Charon's ferry.

Bottom of the Hill
A grey, gritty beach meets the edge of the river. A low, bare hill rises gently upward.

You can see Charon's ferry (in which is Charon) and a worryingly large boulder here.

>get in
You must supply a noun.

>get into ferry
You can't see any such thing.

>z
Time passes.

>l
Bottom of the Hill
A grey, gritty beach meets the edge of the river. A low, bare hill rises gently upward.

You can see a worryingly large boulder here.

>l ferry
You can't see any such thing.

* * *

>x board
Charon irritably angles the clipboard away from you, but not before you've seen the list of names he's expecting for the trip across the river:

Sisyphus
Tantalus
Prometheus
Danaids
Zeno

>talk to charon
Before you can get a word in, Charon monotones, "And you are?"

Recalling the list of names on the clipboard, you say:

1) "I'm Sisyphus!"

2) "I'm Prometheus!"

3) "Never mind..." 
>

>1
Charon looks at you blankly, "Sure. Pay me.". 

He holds out a bony hand.

* * *

>pay charon
You hand over the small coin. Charon drops it into a pocket and gestures at the ferry.

>get into boat
Charon sets about unmooring the ferry.

>z
Time passes.

Charon steps deftly into the ferry and takes up his position at the oars.

* * *

>z
Time passes.

With a series of surprisingly muscular pulls on the oars, Charon sends the ferry across the river. You barely have time to take in the gloomy fog and lack of scenery before the prow of the boat grinds onto the rocky sand of a beach.

Charon looks at you implacably. You intuit that it's time for you to get out.

>x charon
Charon is one tall drink of stagnant water. His eyes look sourly out from beneath a cowl. He is sitting at the oars.

>get out
You get out of Charon's ferry.

Bottom of the Hill
A grey, gritty beach meets the edge of the river. A low, bare hill rises gently upward.

You can see Charon's ferry (in which is Charon) and a worryingly large boulder here.

Before he departs, Charon mentions you can get to your punishment faster by just announcing yourself immediately, such as saying "I am Sisyphus." His duty discharged, Charon oars away without giving you a another thought.

>I am sisyphus
Charon told you that would only work on arrival. You're stuck here.

>l
Bottom of the Hill
A grey, gritty beach meets the edge of the river. A low, bare hill rises gently upward.

You can see a worryingly large boulder here.

>x boulder
That really is a lot of rock.

>smell rock
A faint aroma of crushed bones.

>taste rock
Nothing tastes of anything in Hades.

>eat rock
Your eating days are over.

>drink rock
Your drinking days are over.

>lift rock
That's not a verb I recognise.

>get rock
That would be hilarious, but it's too big, too heavy, and too destined to punish you for that.

>kill rock
Wrong game.

>attack rock
Wrong game.

* * *

>talk to charon
Before you can get a word in, Charon monotones, "And you are?"

Recalling the list of names on the clipboard, you say:

1) "I'm Sisyphus!"

2) "I'm Prometheus!"

3) "Never mind..." 
>

>2
Charon looks at you blankly, "Sure. Pay me.". 

He holds out a bony hand.

>pay charo
You can't see any such thing.

>pay charon
You hand over the small coin. Charon drops it into a pocket and gestures at the ferry.

>i am prometheus
The Rock
A unpleasantly jagged black rock rises from the ash colored sand of the beach.

* * *

>z
Time passes.

With a series of surprisingly muscular pulls on the oars, Charon sends the ferry across the river. You barely have time to take in the gloomy fog and lack of scenery before the prow of the boat grinds onto the rocky sand of a beach.

Charon looks at you implacably. You intuit that it's time for you to get out.

>l
The Rock (in Charon's ferry)
A unpleasantly jagged black rock rises from the ash colored sand of the beach.

In Charon's ferry you can see Charon.

>get out
Charon jumps lightly out of the ferry behind you and leads to you the imposing black rock embedded in the beach. With his guidance you lie down on top of it and Charon chains you securely in place. This done, he descends from the rock and walks back to the ferry.

You get out of Charon's ferry.

The Rock
A unpleasantly jagged black rock rises from the ash colored sand of the beach.

You can see Charon's ferry (in which is Charon) here.

Before he departs, Charon mentions you can get to your punishment faster by just announcing yourself immediately, such as saying "I am Prometheus." His duty discharged, Charon oars away without giving you a another thought.

I beg your pardon?

>l
The Rock
A unpleasantly jagged black rock rises from the ash colored sand of the beach.

>down
You are tightly chained to the rock, you're not going anywhere. At best you could writhe, struggle, strain, or something like that.

>get off
But you aren't in anything at the moment.

* * *

>x board
Charon irritably angles the clipboard away from you, but not before you've seen the list of names he's expecting for the trip across the river:

Sisyphus
Tantalus
Prometheus
Danaids
Zeno

>x clipboard
Charon irritably angles the clipboard away from you, but not before you've seen the list of names he's expecting for the trip across the river:

Sisyphus
Tantalus
Prometheus
Danaids
Zeno

>talk to charon
Before you can get a word in, Charon monotones, "And you are?"

Recalling the list of names on the clipboard, you say:

Error: no text for Talk to Charon.

1) "I'm Sisyphus!"

2) "Never mind..." 
>

>1
Charon raises his eyebrow, "Oh yeah? Sure thing. Give me the coin.". 

He holds out a bony hand.

>pay charon
You hand over the small coin. Charon drops it into a pocket and gestures at the ferry. "Looks like we're in business. Get in."

>x charon
Charon is one tall drink of stagnant water. His eyes look sourly out from beneath a cowl. He is holding a clipboard.

>get in
Charon is seemingly at pains not to help you step into the ferry. Once you're established, he climbs in after you.

Charon sets about unmooring the ferry.

>x charon
Charon is one tall drink of stagnant water. His eyes look sourly out from beneath a cowl. He is holding a clipboard.

Charon steps deftly into the ferry and takes up his position at the oars.

>x charon
Charon is one tall drink of stagnant water. His eyes look sourly out from beneath a cowl. He is sitting at the oars.

With a series of surprisingly muscular pulls on the oars, Charon sends the ferry across the river. You barely have time to take in the gloomy fog and lack of scenery before the prow of the boat grinds onto the rocky sand of a beach.

Charon looks at you implacably. You intuit that it's time for you to get out.

>x charon
Charon is one tall drink of stagnant water. His eyes look sourly out from beneath a cowl. He is sitting at the oars.

>x gerry
You can't see any such thing.

>x ferry
It's Charon's ferry, not totally unlike a small dinghy. Right now it is grounded on a gritty beach.

In Charon's ferry is Charon.

>restartr
That's not a verb I recognise.

>restart
Are you sure you want to restart?

>y
Let's Play: Ancient Greek Punishment: The Text Adventure
An Interactive Fiction by Pippin Barr
Release 1 / Serial number 190606 / Inform 7 build 6M62 (I6/v6.33 lib 6/12N) SD

Bank of the River Styx
Here you are at the famous River Styx. The water flows sluggishly by.

You can see Charon's ferry and Charon here.

>read clipboard
Charon irritably angles the clipboard away from you, but not before you've seen the list of names he's expecting for the trip across the river:

Sisyphus
Tantalus
Prometheus
Danaids
Zeno

>read obol
You can't see any such thing.

>read mouth
You purse your lips and can just make them out while staring strenuously downward. As you do, you feel something in your mouth.

* * *

>open mouth
You open your mouth and neatly catch the small coin that drops out.

>x clipboard
Charon irritably angles the clipboard away from you, but not before you've seen the list of names he's expecting for the trip across the river:

Sisyphus
Tantalus
Prometheus
Danaids
Zeno

>talk to charon
Before you can get a word in, Charon monotones, "And you are?"

Recalling the list of names on the clipboard, you say:

1) "I'm Sisyphus!"

2) "Never mind..." 
>

* * *

>pay charon
You hand over the small coin. Charon drops it into a pocket and gestures at the ferry.

>get into boat
You get into Charon's ferry.

* * *

>pay charon
You hand over the small coin. Charon drops it into a pocket and gestures at the ferry.

>x pocket
Looks roomy.

>search charon's pocket
Charon's frown is enough to prevent you.

>search pocket
Charon's frown is enough to prevent you.

* * *

>open mouth
You open your mouth and neatly catch the small coin that drops out.

>x coin
(the obol)
A small silver coin imprinted with the blurry image of a sleepy man's face.

>x coin face
He looks like he's been through a lot.

>x face
He looks like he's been through a lot.

>x sleepy man
He looks like he's been through a lot.

>x man
You can't see any such thing.

>x charon
Charon is one tall drink of stagnant water. His eyes look sourly out from beneath a cowl. He is holding a clipboard.

* * *

Let's Play: Ancient Greek Punishment: The Text Adventure
An Interactive Fiction by Pippin Barr
Release 1 / Serial number 190624 / Inform 7 build 6M62 (I6/v6.33 lib 6/12N) SD

Type HELP for help.

The Bank of the River Styx
Here you are on the gritty beach at the edge of the famous River Styx. The water flows sluggishly by.

You can see Charon's ferry and Charon here.

>open player's mouth
It isn't something you can open.

>x mouth
You purse your lips and can just make them out while staring strenuously downward.

>x obo;
You can't see any such thing.

>x obol
You can't see any such thing.

>x my mouth
You purse your lips and can just make them out while staring strenuously downward.

* * *

Let's Play: Ancient Greek Punishment: The Text Adventure
An Interactive Fiction by Pippin Barr
Release 1 / Serial number 190624 / Inform 7 build 6M62 (I6/v6.33 lib 6/12N) SD

Type HELP for help.

The Bank of the River Styx
Here you are on the gritty beach at the edge of the famous River Styx. The water flows sluggishly by.

You can see Charon's ferry and Charon here.

>pay charon
You don't have any money.

>give coin to charon
You can't see any such thing.

>test sisyphus
(Testing.)

>[1] open mouth
You open your mouth and neatly catch the small coin that drops out.

>[2] x clipboard
Charon irritably angles the clipboard away from you, but not before you've seen the list of names he's expecting for the trip across the river:

Sisyphus
Tantalus
Prometheus
Danaids
Zeno

>[3] talk to charon
Charon looks at you gloomily.

1) "Hi..." 
2) "Uh, bye..." 
>> [4] 1
Charon sighs. "And you are...?".

1) "I'm Sisyphus!"

2) "Uh, bye..." 
>

* * *

>pay charon
You don't have any money.

>open mouth
You open your mouth and neatly catch the small coin that drops out.

* * *

Let's Play: Ancient Greek Punishment: The Text Adventure
An Interactive Fiction by Pippin Barr
Release 1 / Serial number 190624 / Inform 7 build 6M62 (I6/v6.33 lib 6/12N) SD

Type HELP for help.

The Bank of the River Styx
Here you are on the gritty beach at the edge of the famous River Styx. The water flows sluggishly by.

You can see Charon's ferry and Charon here.

>pour charon inferry
I only understood you as far as wanting to pour Charon.

>pour charon into ferry
You're not making a lot of sense.

* * *

Let's Play: Ancient Greek Punishment: The Text Adventure
An Interactive Fiction by Pippin Barr
Release 1 / Serial number 190624 / Inform 7 build 6M62 (I6/v6.33 lib 6/12N) SD

Type HELP for help.

The Bank of the River Styx
Here you are on the gritty beach at the edge of the famous River Styx. The water flows sluggishly by.

You can see Charon's ferry and Charon here.

>push
What do you want to push?

>sisyphus
Bottom of the Hill
A grey, gritty beach meets the edge of the river. A low, bare hill rises gently upward.

You can see a worryingly large boulder here.

>push
(the worryingly large boulder)
You furrow your brow and heave the boulder forward.

A Little Way Up the Hill
Just above the beach the grit-sand turns into a packed dirt of the same colour. The occasional spring of dead grass serves to liven it up.

>push
(the worryingly large boulder)
You furrow your brow and heave the boulder forward.

Partway Up the Hill
The hill slopes up and down away from you, formidable in its general featurelessness. It looks like you're exactly half-way up. Or down.

* * *

>push
What do you want to push?

>push boulder
You furrow your brow and heave the boulder forward.

The Top of the Hill
The view is disappointing, with just the river below and everywhere a thick blanket of fog that prevents you seeing far in any direction. You should really go get the boulder.

The boulder slips from your grasp as though it has a mind of its own and starts rolling back down the hill

>z
Time passes.

Below, you see the boulder rolling down the hill.

>l
The Top of the Hill
The view is disappointing, with just the river below and everywhere a thick blanket of fog that prevents you seeing far in any direction. You should really go get the boulder.

Below, you see the boulder rolling down the hill.

>l
The Top of the Hill
The view is disappointing, with just the river below and everywhere a thick blanket of fog that prevents you seeing far in any direction. You should really go get the boulder.

Below, you see the boulder rolling down the hill.

>l
The Top of the Hill
The view is disappointing, with just the river below and everywhere a thick blanket of fog that prevents you seeing far in any direction. You should really go get the boulder.

You see the boulder settle into place at the bottom of the hill.

* * *

>push
(the worryingly large boulder)
You furrow your brow and heave the boulder forward.

A Fair Way Up the Hill
A continuation of this relentless expanse of hillside. There seems to be a small hole in the dirt.

>z
Time passes.

The boulder rolls calmly down the hill.

>s
You can't go that way.

Below, you see the boulder rolling down the hill.

>d
Partway Up the Hill
Below, you see the boulder rolling down the hill.

>d
A Little Way Up the Hill

>d
Bottom of the Hill
A grey, gritty beach meets the edge of the river. To the north a low, bare hill rises gently upward.

You can see a worryingly large boulder here.

* * *

Let's Play: Ancient Greek Punishment: The Text Adventure
An Interactive Fiction by Pippin Barr
Release 1 / Serial number 190624 / Inform 7 build 6M62 (I6/v6.33 lib 6/12N) SD

Type HELP for help.

The Bank of the River Styx
Here you are on the gritty beach at the edge of the famous River Styx. The water flows sluggishly by.

You can see Charon's ferry and Charon here.

>push boulder north
You can't see any such thing.

>l
Bank of the River Styx
Here you are at the famous River Styx. The water flows sluggishly by.

You can see Charon's ferry and Charon here.

>sisyphus
Bottom of the Hill
A grey, gritty beach meets the edge of the river. To the north a low, bare hill rises gently upward.

You can see a worryingly large boulder here.

>push boulder north
A Little Way Up the Hill

>l
A Little Way Up the Hill

>s
Bottom of the Hill
A grey, gritty beach meets the edge of the river. To the north a low, bare hill rises gently upward.

You can see a worryingly large boulder here.

>push boulder north
A Little Way Up the Hill

>s
Bottom of the Hill
A grey, gritty beach meets the edge of the river. To the north a low, bare hill rises gently upward.

You can see a worryingly large boulder here.

* * *

>push boulder north
You can't see any such thing.

>sisyphus
Bottom of the Hill
A grey, gritty beach meets the edge of the river. To the north a low, bare hill rises gently upward.

You can see a worryingly large boulder here.

* * *

>push boulder north
A Little Way Up the Hill

>push boulder north
Partway Up the Hill

>s
A Little Way Up the Hill
Unattended, the boulder rolls back down the hill.

>push boulder
It's got too much momentum to stop now!

Unattended, the boulder rolls back down the hill.

>l
A Little Way Up the Hill

* * *

>s
Bottom of the Hill
A grey, gritty beach meets the edge of the river. To the north a low, bare hill rises gently upward.

You can see a worryingly large boulder here.

>push boulder n
A Little Way Up the Hill

>push boulder n
Partway Up the Hill

>s
A Little Way Up the Hill
Unattended, the boulder rolls back down the hill.

>push boulder n
It's got too much momentum to stop now!

Partway Up the Hill

* * *

Let's Play: Ancient Greek Punishment: The Text Adventure
An Interactive Fiction by Pippin Barr
Release 1 / Serial number 190624 / Inform 7 build 6M62 (I6/v6.33 lib 6/12N) SD

Type HELP for help.

The Bank of the River Styx
Here you are on the gritty beach at the edge of the famous River Styx. The water flows sluggishly by.

You can see Charon's ferry and Charon here.

>restart
Are you sure you want to restart?

>y
Let's Play: Ancient Greek Punishment: The Text Adventure
An Interactive Fiction by Pippin Barr
Release 1 / Serial number 190619 / Inform 7 build 6M62 (I6/v6.33 lib 6/12N) SD

Type HELP for help.

The Bank of the River Styx
Here you are at the famous River Styx. The water flows sluggishly by.

You can see Charon's ferry and Charon here.

>restore
Restore failed.

>l
The Bank of the River Styx
Here you are at the famous River Styx. The water flows sluggishly by.

You can see Charon's ferry and Charon here.

>save
Save failed.

>restore
Restore failed.

>clear
What do you want to clear?

I beg your pardon?

I beg your pardon?

>restore
Restore failed.

* * *

>l
The Bank of the River Styx
Here you are at the famous River Styx. The water flows sluggishly by.

You can see Charon's ferry and Charon here.

>help
This is a work of interactive fiction and tries to follow standard ways of existing in a textual world: 

 To look at where you are type LOOK. 
 To look at something type LOOK AT THING or EXAMINE THING. 
 To pick something up type GET THING or TAKE THING. 
 To talk to someone type TALK TO PERSON. 
 To go somewhere type a compass direction.

Generally speaking, look at everything you can and then work out what to do from there.

>look
The Bank of the River Styx
Here you are at the famous River Styx. The water flows sluggishly by.

You can see Charon's ferry and Charon here.

>look at river
The river seems to sneer at you.

>look at sneer
Seems a little unnecessary.

* * *

Let's Play: Ancient Greek Punishment: The Text Adventure
An Interactive Fiction by Pippin Barr
Release 1 / Serial number 190624 / Inform 7 build 6M62 (I6/v6.33 lib 6/12N) SD

Type HELP for help.

The Bank of the River Styx
Here you are on the gritty beach at the edge of the famous River Styx. The water flows sluggishly by.

You can see Charon's ferry and Charon here.

>say boo to Charon
There is no reply.

>say boo
(to Charon)
There is no reply.

>ask charon about life
You start trying to speak, but there's something in your mouth.

>talk to charon
Charon looks at you gloomily.

1) "Hi..." 
2) Error: no link text for My Name. 
3) "Uh, bye..." 
(or 0 to say nothing)
>

* * *

Let's Play: Ancient Greek Punishment: The Text Adventure
An Interactive Fiction by Pippin Barr
Release 1 / Serial number 190624 / Inform 7 build 6M62 (I6/v6.33 lib 6/12N) SD

Type HELP for help.

The Bank of the River Styx
Here you are on the gritty beach at the edge of the famous River Styx. The water flows sluggishly by.

You can see Charon's ferry and Charon here.

>say hello
(to Charon)
There is no reply.

* * *

Let's Play: Ancient Greek Punishment: The Text Adventure
An Interactive Fiction by Pippin Barr
Release 1 / Serial number 190624 / Inform 7 build 6M62 (I6/v6.33 lib 6/12N) SD

Type HELP for help.

The Bank of the River Styx
Here you are on the gritty beach at the edge of the famous River Styx. The water flows sluggishly by.

You can see Charon's ferry and Charon here.

>say jeeves
(to Charon)
There is no reply.

>say "hello"
(to Charon)
There is no reply.

* * *

Let's Play: Ancient Greek Punishment: The Text Adventure
An Interactive Fiction by Pippin Barr
Release 1 / Serial number 190624 / Inform 7 build 6M62 (I6/v6.33 lib 6/12N) SD

Type HELP for help.

The Bank of the River Styx
Here you are on the gritty beach at the edge of the famous River Styx. The water flows sluggishly by.

You can see Charon's ferry and Charon here.

>say yes
(to Charon)
There is no reply.

>say no
(to Charon)
There is no reply.

>say sorry
(to Charon)
There is no reply.

>say peeps
(to Charon)
There is no reply.

* * *

Let's Play: Ancient Greek Punishment: The Text Adventure
An Interactive Fiction by Pippin Barr
Release 1 / Serial number 190624 / Inform 7 build 6M62 (I6/v6.33 lib 6/12N) SD

Type HELP for help.

The Bank of the River Styx
Here you are on the gritty beach at the edge of the famous River Styx. The water flows sluggishly by.

You can see Charon's ferry and Charon here.

>sisyphus
You utter the magical words and the world seems to shudder on its axis, blurring everything for a moment. When you adjust your vision, your surroundings have changed.

Bottom of the Hill
A grey, gritty beach meets the edge of the river. A low, bare hill rises gently upward.

You can see a worryingly large boulder here.

>get boulder
That would be hilarious, but it's too big, too heavy, and too destined to punish you for that.

>drop boulder
The worryingly large boulder is already here.

>restart
Are you sure you want to restart?

>y
Let's Play: Ancient Greek Punishment: The Text Adventure
An Interactive Fiction by Pippin Barr
Release 1 / Serial number 190606 / Inform 7 build 6M62 (I6/v6.33 lib 6/12N) SD

Bank of the River Styx
Here you are at the famous River Styx. The water flows sluggishly by.

You can see Charon here.

>test sisyphus
(Testing.)

>[1] open mouth
You open your mouth and neatly catch the small coin that drops out.

>[2] x clipboard
Charon irritably angles the clipboard away from you, but not before you've seen the list of names he's expecting for the trip across the river:

Sisyphus
Tantalus
Prometheus
Danaids
Zeno

>[3] talk to charon
Before you can get a word in, Charon monotones, "And you are?"

Recalling the list of names on the clipboard, you say:

Error: no text for Talk to Charon.

1) "I'm Sisyphus!"

2) "Never mind..." 
>> [4] 1
Charon raises his eyebrow, "Oh yeah? Sure thing. Give me the coin.". 

He holds out a bony hand.

>[5] pay charon
You hand over the small coin. Charon drops it into a pocket and gestures at the ferry. "Looks like we're in business. Get in."

>[6] get into boat
Charon is seemingly at pains not to help you step into the ferry. Once you're established, he climbs in after you.

Charon sets about unmooring the ferry.

>l
Bank of the River Styx (in Charon's ferry)
Here you are at the famous River Styx. The water flows sluggishly by.

You can see Charon here.

Charon steps deftly into the ferry and takes up his position at the oars.

>l
Bank of the River Styx (in Charon's ferry)
Here you are at the famous River Styx. The water flows sluggishly by.

In Charon's ferry you can see Charon.

With a series of surprisingly muscular pulls on the oars, Charon sends the ferry across the river.

>l
Bottom of the Hill (in Charon's ferry)
A level area meets the edge of the river, then rises gently upward to the north.

You can see a worryingly large boulder here.

In Charon's ferry you can see Charon.

* * *

>sisyphus
You utter the magical words and the world seems to shudder on its axis, blurring everything for a moment. When you adjust your vision, your surroundings have changed.

Bottom of the Hill
A grey, gritty beach meets the edge of the river. A low, bare hill rises gently upward.

You can see a worryingly large boulder here.

>l
Bottom of the Hill
A level area meets the edge of the river, then rises gently upward to the north.

* * *

>sisyphus
You utter the magical words and the world seems to shudder on its axis, blurring everything for a moment. When you adjust your vision, your surroundings have changed.

Bottom of the Hill
A grey, gritty beach meets the edge of the river. A low, bare hill rises gently upward.

You can see a worryingly large boulder here.

>n
A Little Way Up the Hill

>n
Partway Up the Hill

>l
Top of the Hill
The top of the hill.

>s
Halfway Up the Hill
Halfway up the hill.

>s
Bottom of the Hill
A grey, gritty beach meets the edge of the river. To the north a low, bare hill rises gently upward.

You can see a worryingly large boulder here.

>push boulder
Nothing obvious happens.

>push boulder n
Halfway Up the Hill
Halfway up the hill.

* * *

>n
Partway Up the Hill

>n
A Fair Way Up the Hill

>n
Quite Far Up the Hill

>n
Nearly the Top of the Hill

>n
The Top of the Hill
The top of the hill.

I beg your pardon?

>s
Nearly the Top of the Hill
Almost at the top of the hill.

>s
Quite Far Up the Hill
Almost at the top of the hill.

>s
A Fair Way Up the Hill
Further up the hill.

>s
Partway Up the Hill
Partway up the hill.

>s
A Little Way Up the Hill

* * *

>n
Nearly the Top of the Hill

>w
You can't go that way.

* * *

>e
You can't go that way.

>n
The Top of the Hill
The top of the hill. The view is disappointing, with just the river to the south and everywhere a thick blanket of fog that prevents you seeing far in any direction.

* * *

>n
A Little Way Up the Hill

>s
Bottom of the Hill
A grey, gritty beach meets the edge of the river. To the north a low, bare hill rises gently upward.

You can see a worryingly large boulder here.

>nn
That's not a verb I recognise.

>n
Halfway Up the Hill
Halfway up the hill.

>n
You can't go that way.

>s
Bottom of the Hill
A grey, gritty beach meets the edge of the river. To the north a low, bare hill rises gently upward.

You can see a worryingly large boulder here.

>s
You can't go that way.

>push boulder n
Halfway Up the Hill
Halfway up the hill.

>l
Halfway Up the Hill
Halfway up the hill.

You can see a worryingly large boulder here.

* * *

>n
A Little Way Up the Hill

>w
You can't go that way.

* * *

>sisyphus
You utter the magical words and the world seems to shudder on its axis, blurring everything for a moment. When you adjust your vision, your surroundings have changed.

Bottom of the Hill
A grey, gritty beach meets the edge of the river. A low, bare hill rises gently upward.

You can see a worryingly large boulder here.

>push
(the worryingly large boulder)
You furrow your brow and heave the boulder forward.

A Little Way Up the Hill
Just above the beach the grit-sand turns into a packed dirt of the same colour. The occasional sprig of dead grass serves to liven it up.

* * *

>push
(the worryingly large boulder)
You furrow your brow and heave the boulder forward.

Partway Up the Hill
The hill slopes up and down away from you, formidable in its general featurelessness. It looks like you're exactly half-way up. Or down.

>d
A Little Way Up the Hill
Just above the beach the grit-sand turns into a packed dirt of the same colour. The occasional spring of dead grass serves to liven it up.

The boulder rolls into view.

>d
Bottom of the Hill
A grey, gritty beach meets the edge of the river. A low, bare hill rises gently upward.

The boulder rolls into view.

The boulder settles ponderously back at its starting position.

>push
(the worryingly large boulder)
You furrow your brow and heave the boulder forward.

A Little Way Up the Hill
Just above the beach the grit-sand turns into a packed dirt of the same colour. The occasional spring of dead grass serves to liven it up.

* * *

>push
(the worryingly large boulder)
You furrow your brow and heave the boulder forward.

Quite Far Up the Hill
Far enough up the hill to be out of breath if you don't get out much. Like the rest of the hill, this part is made entirely out of dirt.

>d
A Fair Way Up the Hill
A continuation of this relentless expanse of hillside. There seems to be a small hole in the dirt.

The boulder rolls into view.

>d
Partway Up the Hill
The hill slopes up and down away from you, formidable in its general featurelessness. It looks like you're exactly half-way up. Or down.

The boulder rolls into view.

>d
A Little Way Up the Hill
Just above the beach the grit-sand turns into a packed dirt of the same colour. The occasional spring of dead grass serves to liven it up.

The boulder rolls into view.

* * *

>d
Bottom of the Hill
A grey, gritty beach meets the edge of the river. A low, bare hill rises gently upward.

The boulder rolls into view.

The boulder settles ponderously back at its starting position.

>d
You can't go that way.

>d
You can't go that way.

>push
(the worryingly large boulder)
You furrow your brow and heave the boulder forward.

A Little Way Up the Hill
Just above the beach the grit-sand turns into a packed dirt of the same colour. The occasional spring of dead grass serves to liven it up.

* * *

>push
(the worryingly large boulder)
You furrow your brow and heave the boulder forward.

Quite Far Up the Hill
Far enough up the hill to be out of breath if you don't get out much. Like the rest of the hill, this part is made entirely out of dirt.

>z
Time passes.

The boulder rolls calmly away down the hill.

>d
A Fair Way Up the Hill
A continuation of this relentless expanse of hillside. There seems to be a small hole in the dirt.

You can see a worryingly large boulder here.

The boulder rolls calmly away down the hill.

>d
Partway Up the Hill
The hill slopes up and down away from you, formidable in its general featurelessness. It looks like you're exactly half-way up. Or down.

You can see a worryingly large boulder here.

The boulder rolls calmly away down the hill.

>d
A Little Way Up the Hill
Just above the beach the grit-sand turns into a packed dirt of the same colour. The occasional spring of dead grass serves to liven it up.

You can see a worryingly large boulder here.

The boulder rolls calmly away down the hill.
You see the boulder settle into place at the bottom of the hill.

* * *

>d
A Little Way Up the Hill
Just above the beach the grit-sand turns into a packed dirt of the same colour. The occasional spring of dead grass serves to liven it up.

The boulder rolls into view.

>push
(the worryingly large boulder)
You go to push the boulder, but it's big, heavy, and on the move so you wisely step aside.

The boulder rolls calmly away down the hill.

You see the boulder settle into place at the bottom of the hill.

>l
A Little Way Up the Hill

>l
A Little Way Up the Hill

>d
Bottom of the Hill
A grey, gritty beach meets the edge of the river. To the north a low, bare hill rises gently upward.

You can see a worryingly large boulder here.

>push
(the worryingly large boulder)
You furrow your brow and heave the boulder forward.

A Little Way Up the Hill

>push
(the worryingly large boulder)
You furrow your brow and heave the boulder forward.

Partway Up the Hill

>push
(the worryingly large boulder)
You furrow your brow and heave the boulder forward.

A Fair Way Up the Hill

>push
(the worryingly large boulder)
You furrow your brow and heave the boulder forward.

Quite Far Up the Hill

>push
(the worryingly large boulder)
You furrow your brow and heave the boulder forward.

Nearly the Top of the Hill

>push
(the worryingly large boulder)
You furrow your brow and heave the boulder forward.

The Top of the Hill
The view is disappointing, with just the river to the south and everywhere a thick blanket of fog that prevents you seeing far in any direction.

The boulder slips from your grasp as though it has a mind of its own and starts rolling back down the hill

>d
Nearly the Top of the Hill
You can see a worryingly large boulder here.

The boulder rolls calmly away down the hill.

>l
Nearly the Top of the Hill
Below, you see the boulder rolling down the hill.

>sigh
That's not a verb I recognise.

>z
Time passes.

Below, you see the boulder rolling down the hill.

>z
Time passes.

Below, you see the boulder rolling down the hill.

>z
Time passes.

You see the boulder settle into place at the bottom of the hill.

>d
Quite Far Up the Hill

>d
A Fair Way Up the Hill

>d
Partway Up the Hill

>d
A Little Way Up the Hill

* * *

>d
A Little Way Up the Hill
Just above the beach the grit-sand turns into a packed dirt of the same colour. The occasional spring of dead grass serves to liven it up.

The boulder rolls into view.

>push boulder down
The boulder is rolling downhill just fine without your help.

The boulder rolls calmly away down the hill.
You see the boulder settle into place at the bottom of the hill.

>d
Bottom of the Hill
A grey, gritty beach meets the edge of the river. To the north a low, bare hill rises gently upward.

You can see a worryingly large boulder here.

* * *

>push
(the worryingly large boulder)
You furrow your brow and heave the boulder forward.

Quite Far Up the Hill

>z
Time passes.

The boulder rolls calmly away down the hill.

>z
Time passes.

Below, you see the boulder rolling down the hill.

* * *

>z
Time passes.

You see the boulder settle into place at the bottom of the hill.

>sisyphus
Nothing happens. You didn't think escape would be that easy did you?

>restart
Are you sure you want to restart?

* * *

>y
Let's Play: Ancient Greek Punishment: The Text Adventure
An Interactive Fiction by Pippin Barr
Release 1 / Serial number 190606 / Inform 7 build 6M62 (I6/v6.33 lib 6/12N) SD

Bank of the River Styx
Here you are at the famous River Styx. The water flows sluggishly by.

You can see Charon's ferry and Charon here.

>sisyphus
Bottom of the Hill
A grey, gritty beach meets the edge of the river. To the north a low, bare hill rises gently upward.

You can see a worryingly large boulder here.

>push
(the worryingly large boulder)
You furrow your brow and heave the boulder forward.

A Little Way Up the Hill

* * *

>push
(the worryingly large boulder)
You furrow your brow and heave the boulder forward.

A Fair Way Up the Hill

>s
You can't go that way.

The boulder rolls calmly away down the hill.

>up
Quite Far Up the Hill
Below, you see the boulder rolling down the hill.

>z
Time passes.

You see the boulder settle into place at the bottom of the hill.

>restart
Are you sure you want to restart?

* * *

>push
(the worryingly large boulder)
You furrow your brow and heave the boulder forward.

Partway Up the Hill

>down
A Little Way Up the Hill
The boulder rolls into view.

>push
(the worryingly large boulder)
You go to push the boulder, but it's big, heavy, and on the move so it pushes you instead.
The boulder is rolling downhill just fine without your help.

The boulder rolls calmly away down the hill.
You see the boulder settle into place at the bottom of the hill.

>l
A Little Way Up the Hill

* * *

>d
A Little Way Up the Hill
Just above the beach the grit-sand turns into a packed dirt of the same colour. The occasional spring of dead grass serves to liven it up.

The boulder rolls into view.

>z
Time passes.

The boulder rolls calmly away down the hill.

You see the boulder settle into place at the bottom of the hill.

>d
Bottom of the Hill
A grey, gritty beach meets the edge of the river. A low, bare hill rises gently upward.

You can see a worryingly large boulder here.

>x worryingly
That really is a lot of rock.

>push
(the worryingly large boulder)
You furrow your brow and heave the boulder forward.

A Little Way Up the Hill
Just above the beach the grit-sand turns into a packed dirt of the same colour. The occasional spring of dead grass serves to liven it up.

* * *

>push
(the worryingly large boulder)
You go to push the boulder, but it's big, heavy, and on the move so you wisely step aside.

The boulder rolls calmly away down the hill.

You see the boulder settle into place at the bottom of the hill.

>push
(the dead grass)
It is fixed in place.

>d
Bottom of the Hill
A grey, gritty beach meets the edge of the river. A low, bare hill rises gently upward.

You can see a worryingly large boulder here.

* * *

>push
(the worryingly large boulder)
You furrow your brow and heave the boulder forward.

Partway Up the Hill
The hill slopes up and down away from you, formidable in its general featurelessness. It looks like you're exactly half-way up. Or down.

>push boulder down
For reasons known only to you, you give the boulder a little push downhill.

The boulder rolls calmly away down the hill.

>d
A Little Way Up the Hill
Just above the beach the grit-sand turns into a packed dirt of the same colour. The occasional spring of dead grass serves to liven it up.

You can see a worryingly large boulder here.

The boulder rolls calmly away down the hill.

You see the boulder settle into place at the bottom of the hill.

>d
Bottom of the Hill
A grey, gritty beach meets the edge of the river. A low, bare hill rises gently upward.

You can see a worryingly large boulder here.

>push
(the worryingly large boulder)
You furrow your brow and heave the boulder forward.

A Little Way Up the Hill
Just above the beach the grit-sand turns into a packed dirt of the same colour. The occasional spring of dead grass serves to liven it up.

* * *

>d
A Little Way Up the Hill
Just above the beach the grit-sand turns into a packed dirt of the same colour. The occasional spring of dead grass serves to liven it up.

The boulder rolls into view.

>push boulder down
The boulder is rolling downhill just fine without your help.

The boulder rolls calmly away down the hill.

You see the boulder settle into place at the bottom of the hill.

>d
Bottom of the Hill
A grey, gritty beach meets the edge of the river. A low, bare hill rises gently upward.

You can see a worryingly large boulder here.

* * *

>push
What do you want to push?

>down
Nearly the Top of the Hill
You can see a worryingly large boulder here.

The boulder rolls calmly down the hill.

>down
Quite Far Up the Hill
You can see a worryingly large boulder here.

The boulder rolls calmly down the hill.

>down
A Fair Way Up the Hill
You can see a worryingly large boulder here.

The boulder rolls calmly down the hill.

>push boulder
You can't see any such thing.

* * *

>push
What do you want to push?

>push boulder
You furrow your brow and heave the boulder forward.

The Top of the Hill
The view is disappointing, with just the river below and everywhere a thick blanket of fog that prevents you seeing far in any direction. You should really go get the boulder.

The boulder slips from your grasp as though it has a mind of its own and starts rolling back down the hillThe boulder rolls into view.

[Your score has just gone up by one point.]

* * *

>push
(the worryingly large boulder)
You furrow your brow and heave the boulder forward.

A Little Way Up the Hill
Just above the beach the grit-sand turns into a packed dirt of the same colour. The occasional sprig of dead grass serves to liven it up.

>up
Partway Up the Hill

Below, you see the boulder settle into place at the bottom of the hill.

* * *

>sisyphus
You utter the magical words and the world seems to shudder on its axis, blurring everything for a moment. When you adjust your vision, your surroundings have changed.

Bottom of the Hill
A grey, gritty beach meets the edge of the river. A low, bare hill rises gently upward.

You can see a worryingly large boulder here.

>push boulder
You furrow your brow and heave the boulder forward.

A Little Way Up the Hill

>push boulder
You furrow your brow and heave the boulder forward.

Partway Up the Hill

>push boulder north
You can't go that way.

With nothing to prevent it, the boulder rolls down the hill.

>s
You can't go that way.

Behind you, you hear the boulder rolling back down the hill.

>down
A Little Way Up the Hill

>down
Bottom of the Hill
A grey, gritty beach meets the edge of the river. To the north a low, bare hill rises gently upward.

You can see a worryingly large boulder here.

>push boulder n
You can't go that way.

>push
(the worryingly large boulder)
You furrow your brow and heave the boulder forward.

A Little Way Up the Hill

* * *

>push
(the worryingly large boulder)
You furrow your brow and heave the boulder forward.

A Fair Way Up the Hill

>push boulder down
For reasons known only to you, you give the boulder a little push back downhill.

With nothing to prevent it, the boulder rolls down the hill.

* * *

>push boulder
You furrow your brow and heave the boulder forward.

A Little Way Up the Hill

>push boulder down
Bottom of the Hill
A grey, gritty beach meets the edge of the river. To the north a low, bare hill rises gently upward.

* * *

>push boulder
You furrow your brow and heave the boulder forward.

A Little Way Up the Hill

>push boulder north
boo

>push boudler south
You can't see any such thing.

>push rock south
You can't go that way.

* * *

>push boulder north
boo

>push boulder up
boo

* * *

>push boulder
You furrow your brow and heave the boulder forward.

A Little Way Up the Hill

>push boulder up
The worryingly large boulder cannot be pushed up or down.

* * *

>sisyphus
You utter the magical words and the world seems to shudder on its axis, blurring everything for a moment. When you adjust your vision, your surroundings have changed.

Bottom of the Hill
A grey, gritty beach meets the edge of the river. A low, bare hill rises gently upward.

You can see a worryingly large boulder here.

>push boulder east
You can't go that way.

>push boulder south
You can't go that way.

* * *

>sisyphus
You utter the magical words and the world seems to shudder on its axis, blurring everything for a moment. When you adjust your vision, your surroundings have changed.

Bottom of the Hill
A grey, gritty beach meets the edge of the river. A low, bare hill rises gently upward.

You can see a worryingly large boulder here.

>push boulder n
A Little Way Up the Hill

* * *

>push boulder n
Partway Up the Hill

>s
A Little Way Up the Hill
The boulder rolls into view.

>push boulder
It's got too much momentum to stop now!

Unattended, the boulder rolls back down the hill.

>s
Bottom of the Hill
A grey, gritty beach meets the edge of the river. To the north a low, bare hill rises gently upward.

You can see a worryingly large boulder here.

* * *

>sisyphus
You utter the magical words and the world seems to shudder on its axis, blurring everything for a moment. When you adjust your vision, your surroundings have changed.

Bottom of the Hill
A grey, gritty beach meets the edge of the river. A low, bare hill rises gently upward.

You can see a worryingly large boulder here.

>push boulder north
You can't go that way.

>l
A Little Way Up the Hill
You can see a worryingly large boulder here.

The boulder rolls back down the hill.

>l
A Little Way Up the Hill
You can see a worryingly large boulder here.

>l
A Little Way Up the Hill
You can see a worryingly large boulder here.

* * *

>push boulder north
You can't go that way.

>n
Partway Up the Hill
Meep

>n
A Fair Way Up the Hill
Meep

>l
A Fair Way Up the Hill
Meep

>s
Partway Up the Hill
Meep

>s
A Little Way Up the Hill
You can see a worryingly large boulder here.

Meep

* * *

>push boulder north
You can't go that way.

>push
(the worryingly large boulder)
You furrow your brow and heave the boulder forward.

A Little Way Up the Hill
Just above the beach the grit-sand turns into a packed dirt of the same colour. The occasional spring of dead grass serves to liven it up.

>x grass
It's dead, Jim.

The boulder rolls calmly away down the hill.

You see the boulder settle into place at the bottom of the hill.

>d
Bottom of the Hill
A grey, gritty beach meets the edge of the river. To the north a low, bare hill rises gently upward.

You can see a worryingly large boulder here.

>push
(the worryingly large boulder)
You furrow your brow and heave the boulder forward.

A Little Way Up the Hill
Just above the beach the grit-sand turns into a packed dirt of the same colour. The occasional spring of dead grass serves to liven it up.

* * *

>push
(the worryingly large boulder)
You furrow your brow and heave the boulder forward.

A Fair Way Up the Hill
A continuation of this relentless expanse of hillside. There seems to be a small hole in the dirt.

>x hole
A small absence of dirt amonst the dirt.

The boulder rolls calmly away down the hill.

>look in hole
The hole is empty.

Below, you see the boulder rolling down the hill.

>d
Partway Up the Hill
The hill slopes up and down away from you, formidable in its general featurelessness. It looks like you're exactly half-way up. Or down.

You see the boulder settle into place at the bottom of the hill.

>d
A Little Way Up the Hill
Just above the beach the grit-sand turns into a packed dirt of the same colour. The occasional spring of dead grass serves to liven it up.

>d
Bottom of the Hill
A grey, gritty beach meets the edge of the river. To the north a low, bare hill rises gently upward.

You can see a worryingly large boulder here.

* * *

>push
(the worryingly large boulder)
You furrow your brow and heave the boulder forward.

Quite Far Up the Hill
Far enough up the hill to be out of breath if you don't get out much. Like the rest of the hill, this part is made entirely out of dirt.

>push
(the worryingly large boulder)
You furrow your brow and heave the boulder forward.

Nearly the Top of the Hill
You can see a note from Zeus here.

>read note
The note reads:

lol
 - Zeus

The boulder rolls calmly away down the hill.

>get note
A sudden gust of wind blows it out of your grasp and away into the distance. The wind sounded weirdly like laughter.

Below, you see the boulder rolling down the hill.

>d
Quite Far Up the Hill
Like the rest of the hill, this part is made entirely out of dirt.

Below, you see the boulder rolling down the hill.

>d
A Fair Way Up the Hill
A continuation of this relentless expanse of hillside. There seems to be a small hole in the dirt.

Below, you see the boulder rolling down the hill.

>d
Partway Up the Hill
The hill slopes up and down away from you, formidable in its general featurelessness. It looks like you're exactly half-way up. Or down.

You see the boulder settle into place at the bottom of the hill.

* * *

>push
(the worryingly large boulder)
You furrow your brow and heave the boulder forward.

Quite Far Up the Hill
Far enough up the hill to be out of breath if you don't get out much. Like the rest of the hill, this part is made entirely out of dirt.

>push
(the worryingly large boulder)
You furrow your brow and heave the boulder forward.

Nearly the Top of the Hill

>push
(the worryingly large boulder)
You furrow your brow and heave the boulder forward.

The Top of the Hill
The view is disappointing, with just the river below and everywhere a thick blanket of fog that prevents you seeing far in any direction.

The boulder slips from your grasp as though it has a mind of its own and starts rolling back down the hill

>l north
You see nothing unexpected in that direction.

Below, you see the boulder rolling down the hill.

>l
The Top of the Hill
The view is disappointing, with just the river below and everywhere a thick blanket of fog that prevents you seeing far in any direction.

Below, you see the boulder rolling down the hill.

>z
Time passes.

Below, you see the boulder rolling down the hill.

* * *

>push boulder north
You can't go that way.

>push boulder
You'll need to specify which direction you want to push it in, but good job holding it in place

>z
Time passes.

The boulder rolls back down the hill.

>s
Bottom of the Hill
A grey, gritty beach meets the edge of the river. To the north a low, bare hill rises gently upward.

You can see a worryingly large boulder here.

>push boulder
You'll need to specify which direction you want to push it in, but good job holding it in place

* * *

>push boulder north
You can't go that way.

>push boulder north
Partway Up the Hill

* * *

>s
A Little Way Up the Hill
Unattended, the boulder rolls back down the hill.

>push boulder north
It's got too much momentum to stop now!

Unattended, the boulder rolls back down the hill.

>l
A Little Way Up the Hill

* * *

>push boulder north
You can't go that way.

>z
Time passes.

Unattended, the boulder rolls back down the hill.

>s
Bottom of the Hill
A grey, gritty beach meets the edge of the river. To the north a low, bare hill rises gently upward.

You can see a worryingly large boulder here.

* * *

>sisyphus
You utter the magical words and the world seems to shudder on its axis, blurring everything for a moment. When you adjust your vision, your surroundings have changed.

Bottom of the Hill
A grey, gritty beach meets the edge of the river. A low, bare hill rises gently upward.

You can see a worryingly large boulder here.

>push boulder up
You furrow your brow and heave the boulder forward.

A Little Way Up the Hill

>up
Partway Up the Hill
Behind you, you hear the boulder rolling back down the hill.

>down
A Little Way Up the Hill

* * *

>down
Bottom of the Hill
A grey, gritty beach meets the edge of the river. To the north a low, bare hill rises gently upward.

You can see a worryingly large boulder here.

>push boulder up
You furrow your brow and heave the boulder forward.

A Little Way Up the Hill

>z
Time passes.

Unattended, the boulder rolls back down the hill.

* * *

>sisyphus
You utter the magical words and the world seems to shudder on its axis, blurring everything for a moment. When you adjust your vision, your surroundings have changed.

Bottom of the Hill
A grey, gritty beach meets the edge of the river. A low, bare hill rises gently upward.

You can see a worryingly large boulder here.

>restart
Are you sure you want to restart?

* * *

>y
Let's Play: Ancient Greek Punishment: The Text Adventure
An Interactive Fiction by Pippin Barr
Release 1 / Serial number 190606 / Inform 7 build 6M62 (I6/v6.33 lib 6/12N) SD

Bank of the River Styx
Here you are at the famous River Styx. The water flows sluggishly by.

You can see Charon here.

>open mouth
You open your mouth and neatly catch the small coin that drops out.

>drop coin
Dropped.

* * *

>open mouth
You open your mouth and neatly catch the small coin that drops out.

>drop obol
Dropped.

>sisyphus
Nothing happens. Do you have the coin?

>get coin
Taken.

>sisyphus
Bottom of the Hill
You're standing at the bottom of a low hill. The slope is fairly gentle.

* * *

>sisyphus
You utter the magical words and the world seems to shudder on its axis, blurring everything for a moment. When you adjust your vision, your surroundings have changed.

Bottom of the Hill
A grey, gritty beach meets the edge of the river. A low, bare hill rises gently upward.

You can see a worryingly large boulder here.

>sisyphus
Nothing happens. You didn't think escape would be that easy did you?

* * *

>y
Let's Play: Ancient Greek Punishment: The Text Adventure
An Interactive Fiction by Pippin Barr
Release 1 / Serial number 190606 / Inform 7 build 6M62 (I6/v6.33 lib 6/12N) SD

Bank of the River Styx
Here you are at the famous River Styx. The water flows sluggishly by.

You can see Charon here.

>sisyphus
Bottom of the Hill
You're standing at the bottom of a low hill. The slope is fairly gentle.

>open mouth
Let's not. You shouldn't just stand around with your mouth open, you know.

* * *

>sisyphus
You utter the magical words and the world seems to shudder on its axis, blurring everything for a moment. When you adjust your vision, your surroundings have changed.

Bottom of the Hill
A grey, gritty beach meets the edge of the river. A low, bare hill rises gently upward.

You can see a worryingly large boulder here.

>touch boulder
No touching!

>up
A Little Way Up the Hill
Just above the beach the grit-sand turns into a packed dirt of the same colour. The occasional spring of dead grass serves to liven it up.

>touch boulder
It's too far away.

>x boulder
That really is a lot of rock.

>smell boulder
It's too far away.

>push
(the dead grass)
Pick on someone your own size.

>push boulder
It's too far away.

* * *

>sisyphus
You utter the magical words and the world seems to shudder on its axis, blurring everything for a moment. When you adjust your vision, your surroundings have changed.

Bottom of the Hill
A grey, gritty beach meets the edge of the river. A low, bare hill rises gently upward.

You can see a worryingly large boulder here.

>up
A Little Way Up the Hill
Just above the beach the grit-sand turns into a packed dirt of the same colour. The occasional sprig of dead grass serves to liven it up.

>push boulder
You'll need to head back down the hill if you want to do anything with the boulder.

>drink river
It's not a nice river.

>x river
The river seems to sneer at you.

>x sneer
What an unpleasant river.

>touch river
No touching!

>get into river
If you ever knew how to swim, you don't anymore.

>l
A Little Way Up the Hill
Just above the beach the grit-sand turns into a packed dirt of the same colour. The occasional sprig of dead grass serves to liven it up.

>x boulder
That really is a lot of rock. At least it looks a bit smaller from up here. You should probably go down and start pushing it up the hill.

>push boulder
You'll need to head back down the hill if you want to do anything with the boulder.

>down
Bottom of the Hill
A grey, gritty beach meets the edge of the river. A low, bare hill rises gently upward.

You can see a worryingly large boulder here.

>push boulder
You furrow your brow and heave the boulder forward.

The post-it note that was attached to the boulder is dislodged and blows away in a sudden gust of wind.

>again
You furrow your brow and heave the boulder forward.

Partway Up the Hill
The hill slopes up and down away from you, formidable in its general featurelessness. It looks like you're exactly half-way up. Or down.

You can see a swan here.

>again
You furrow your brow and heave the boulder forward.

A Fair Way Up the Hill
A continuation of this relentless expanse of hillside. There seems to be a small hole in the dirt.

>again
You furrow your brow and heave the boulder forward.

Quite Far Up the Hill
Far enough up the hill to be out of breath if you don't get out much. Like the rest of the hill, this part is made entirely out of dirt.

You can see a videogame here.

>x videogame
You can't see any such thing.

>l
Quite Far Up the Hill
Far enough up the hill to be out of breath if you don't get out much. Like the rest of the hill, this part is made entirely out of dirt.

You can see a worryingly large boulder here.

Obeying gravity, the boulder rolls calmly down the hill.

* * *

>up
Nearly the Top of the Hill
It's so barren up here you can't even imagine something growing, and you have a pretty good imagination.

You can see a note from Zeus here.

>up
The Top of the Hill
The view is disappointing, with just the river below and everywhere a thick blanket of fog that prevents you seeing far in any direction. You should really go get the boulder.

>d
Nearly the Top of the Hill
It's so barren up here you can't even imagine something growing, and you have a pretty good imagination.

You can see a note from Zeus here.

>d
Quite Far Up the Hill
Like the rest of the hill, this part is made entirely out of dirt.

>d
A Fair Way Up the Hill
A continuation of this relentless expanse of hillside. There seems to be a small hole in the dirt.

>d
Partway Up the Hill
The hill slopes up and down away from you, formidable in its general featurelessness. It looks like you're exactly half-way up. Or down.

>d
A Little Way Up the Hill
Just above the beach the grit-sand turns into a packed dirt of the same colour. The occasional spring of dead grass serves to liven it up.

* * *

>d
Bottom of the Hill
A grey, gritty beach meets the edge of the river. To the north a low, bare hill rises gently upward.

You can see a worryingly large boulder here.

>d
You can't go that way.

>s
The only way is up, baby.

>n
The only way is up, baby.

>w
The only way is up, baby.

>e
The only way is up, baby.

>push boulder s
The only way is up, baby.

* * *

>up
A Fair Way Up the Hill
A continuation of this relentless expanse of hillside. There seems to be a small hole in the dirt.

>x hole
A small absence of dirt amonst the dirt.

>open hole
It isn't something you can open.

>look in hole
The hole is empty.

>up
Quite Far Up the Hill
Far enough up the hill to be out of breath if you don't get out much.Like the rest of the hill, this part is made entirely out of dirt.

>up
Nearly the Top of the Hill

>up
The Top of the Hill
The view is disappointing, with just the river below and everywhere a thick blanket of fog that prevents you seeing far in any direction.

You can see a note from Zeus here.

>read note
The note reads:

lol
 - Zeus

>get note
A sudden gust of wind blows it out of your grasp and away into the distance. The wind sounded weirdly like laughter.

>i
You are carrying nothing.

>l
The Top of the Hill
The view is disappointing, with just the river below and everywhere a thick blanket of fog that prevents you seeing far in any direction.

* * *

>up
A Little Way Up the Hill
Just above the beach the grit-sand turns into a packed dirt of the same colour. The occasional sprig of dead grass serves to liven it up.

>x grass
It's dead, Jim.

>get grass
Leave it alone, it's been through enough.

* * *

>sisyphus
You utter the magical words and the world seems to shudder on its axis, blurring everything for a moment. When you adjust your vision, your surroundings have changed.

Bottom of the Hill
A grey, gritty beach meets the edge of the river. A low, bare hill rises gently upward.

You can see a worryingly large boulder here.

>x boulder
That really is a lot of rock.

>up
A Little Way Up the Hill
Just above the beach the grit-sand turns into a packed dirt of the same colour. The occasional spring of dead grass serves to liven it up.

>x boulder
That really is a lot of rock.

>touch boulder
You can't reach into the Bottom of the Hill.

* * *

>up
A Little Way Up the Hill
Just above the beach the grit-sand turns into a packed dirt of the same colour. The occasional spring of dead grass serves to liven it up.

>x rock
That really is a lot of rock. At least it looks a bit smaller from up here.

>smell boulder
It's too far away.

>x hill
You can't see any such thing.

* * *

>x boulder
That really is a lot of rock.

>x large
That really is a lot of rock.

>push rock
You can't see any such thing.

>push boulder
Nothing obvious happens.

* * *

>sisyphus
You utter the magical words and the world seems to shudder on its axis, blurring everything for a moment. When you adjust your vision, your surroundings have changed.

Bottom of the Hill
A grey, gritty beach meets the edge of the river. A low, bare hill rises gently upward.

You can see a worryingly large boulder here.

>x dirt
Not as dirty as you'd have though.

>get dirt
You're not here to dig holes.

>climb dirt
Nah.

>up
A Little Way Up the Hill
Just above the beach the grit-sand turns into a packed dirt of the same colour. The occasional spring of dead grass serves to liven it up.

>up
Partway Up the Hill
The hill slopes up and down away from you, formidable in its general featurelessness. It looks like you're exactly half-way up. Or down.

>x dirt
Not as dirty as you'd have though.

>x river
The river seems to sneer at you.

>up
A Fair Way Up the Hill
A continuation of this relentless expanse of hillside. There seems to be a small hole in the dirt.

* * *

>up
Quite Far Up the Hill
Far enough up the hill to be out of breath if you don't get out much. Like the rest of the hill, this part is made entirely out of dirt.

>x river
The river seems to sneer at you.

* * *

>sisyphus
You utter the magical words and the world seems to shudder on its axis, blurring everything for a moment. When you adjust your vision, your surroundings have changed.

Bottom of the Hill
A grey, gritty beach meets the edge of the river. A low, bare hill rises gently upward.

You can see a worryingly large boulder here.

>x hill
It's a good, solid hill. It probably never gets depressed.

>get hill
That's hardly portable.

>push hill
It is fixed in place.

* * *

Let's Play: Ancient Greek Punishment: The Text Adventure
An Interactive Fiction by Pippin Barr
Release 1 / Serial number 190624 / Inform 7 build 6M62 (I6/v6.33 lib 6/12N) SD

Type HELP for help.

The Bank of the River Styx
Here you are on the gritty beach at the edge of the famous River Styx. The water flows sluggishly by.

You can see Charon's ferry and Charon here.

>sit
What do you want to sit on?

>ferry
You need to pay Charon before you can get in.

>spit
You spit a small coin into your hand.

>x board
Charon irritably angles the clipboard away from you, but not before you've seen the list of names he's expecting for the trip across the river:

Sisyphus
Tantalus
Prometheus
Danaids
Zeno

>pay charon
Charon looks at you wearily, "No paying until you tell me who you are." (Maybe you should talk to him first.)

>talk to charon
Before you can get a word in, Charon monotones, "And you are?"

Recalling the list of names on the clipboard, you say:

1) "I'm Sisyphus!"

2) "I'm Tantalus!"

3) "I'm Prometheus!"

4) "I'm a Danaid!"

5) "I'm Zeno!"

6) "Never mind..." 
>

* * *

>pay charon
You hand over the small coin. Charon drops it into a pocket and gestures at the ferry. You should probably get in.

>sit
What do you want to sit on?

>the seats
That's not something you can sit down on.

>the ferry
That's not a verb I recognise.

>sit on ferry
Charon takes pains not to help you step into the ferry, but you make it in alright.

Charon sets about unmooring the ferry.

* * *

>sit
What do you want to sit on?

>sit on the ferry
You need to pay Charon before you can get in.

>sit on seats
You need to pay Charon before you can get in.

>sit on charon
He's not something you can sit down on.

>sit on ground
That's not something you can sit down on.

>enter ground
That's not something you can enter.

* * *

Let's Play: Ancient Greek Punishment: The Text Adventure
An Interactive Fiction by Pippin Barr
Release 1 / Serial number 190624 / Inform 7 build 6M62 (I6/v6.33 lib 6/12N) SD

Type HELP for help.

The Bank of the River Styx
Here you are on the gritty beach at the edge of the famous River Styx. The water flows sluggishly by.

You can see Charon's ferry and Charon here.

>sit on ferry
You need to pay Charon before you can get in.

>sit on ground
No rest for the wicked.

>sit on river
No rest for the wicked.

>sit on Charon
No rest for the wicked.

>lie on ferry
No rest for the wicked.

>lie on river
No rest for the wicked.

>shove ferry
Charon will handle all that.

>push ferry
Charon will handle all that.

>shove ferry
Charon will handle all that.

>shove off
You can't see any such thing.

* * *

Let's Play: Ancient Greek Punishment: The Text Adventure
An Interactive Fiction by Pippin Barr
Release 1 / Serial number 190624 / Inform 7 build 6M62 (I6/v6.33 lib 6/12N) SD

Type HELP for help.

The Bank of the River Styx
Here you are on the gritty beach at the edge of the famous River Styx. The water flows sluggishly by.

You can see Charon's ferry and Charon here.

>sleep
But there's so much to do!

* * *

Let's Play: Ancient Greek Punishment: The Text Adventure
An Interactive Fiction by Pippin Barr
Release 1 / Serial number 190624 / Inform 7 build 6M62 (I6/v6.33 lib 6/12N) SD

Type HELP for help.

The Bank of the River Styx
Here you are on the gritty beach at the edge of the famous River Styx. The water flows sluggishly by.

You can see Charon's ferry and Charon here.

>smell me
A faint aroma of crushed bones.

>smell here
You can't see any such thing.

>smell charon
A faint aroma of crushed bones.

>smell ferry
A faint aroma of crushed bones.

* * *

Let's Play: Ancient Greek Punishment: The Text Adventure
An Interactive Fiction by Pippin Barr
Release 1 / Serial number 190624 / Inform 7 build 6M62 (I6/v6.33 lib 6/12N) SD

Type HELP for help.

The Bank of the River Styx
Here you are on the gritty beach at the edge of the famous River Styx. The water flows sluggishly by.

You can see Charon's ferry and Charon here.

>sorry
It's a bit late for that.

>climb
What do you want to climb?

>climb charon
Little is to be achieved by that.

>climb ferry
Little is to be achieved by that.

>sleep
You aren't feeling especially drowsy.

* * *

Let's Play: Ancient Greek Punishment: The Text Adventure
An Interactive Fiction by Pippin Barr
Release 1 / Serial number 190624 / Inform 7 build 6M62 (I6/v6.33 lib 6/12N) SD

Type HELP for help.

The Bank of the River Styx
Here you are on the gritty beach at the edge of the famous River Styx. The water flows sluggishly by.

You can see Charon's ferry and Charon here.

>spit
You spit a small coin into your hand.

>i
You are carrying:
  an obol

>l coin
(the obol)
A small silver coin imprinted with the blurry image of a sleepy man's face.

>l man
Charon is one tall drink of stagnant water. His eyes look sourly out from beneath a cowl. He is holding a clipboard.

>l sleepy man
He looks like he's been through a lot.

* * *

Let's Play: Ancient Greek Punishment: The Text Adventure
An Interactive Fiction by Pippin Barr
Release 1 / Serial number 190624 / Inform 7 build 6M62 (I6/v6.33 lib 6/12N) SD

Type HELP for help.

The Bank of the River Styx
Here you are on the gritty beach at the edge of the famous River Styx. The water flows sluggishly by.

You can see Charon's ferry and Charon here.

>spit out coin
You can't see any such thing.

>spit
You spit a small coin into your hand.

* * *

Let's Play: Ancient Greek Punishment: The Text Adventure
An Interactive Fiction by Pippin Barr
Release 1 / Serial number 190624 / Inform 7 build 6M62 (I6/v6.33 lib 6/12N) SD

Type HELP for help.

The Bank of the River Styx
Here you are on the gritty beach at the edge of the famous River Styx. The water flows sluggishly by.

You can see Charon's ferry and Charon here.

>take charon
I don't suppose Charon would care for that.

>take coin
You can't see any such thing.

* * *

Let's Play: Ancient Greek Punishment: The Text Adventure
An Interactive Fiction by Pippin Barr
Release 1 / Serial number 190624 / Inform 7 build 6M62 (I6/v6.33 lib 6/12N) SD

Type HELP for help.

The Bank of the River Styx
Here you are on the gritty beach at the edge of the famous River Styx. The water flows sluggishly by.

You can see Charon's ferry and Charon here.

>talk  to  charon
Charon raises an eyebrow.

>talk to charon about cats
I only understood you as far as wanting to talk to Charon.

* * *

Let's Play: Ancient Greek Punishment: The Text Adventure
An Interactive Fiction by Pippin Barr
Release 1 / Serial number 190624 / Inform 7 build 6M62 (I6/v6.33 lib 6/12N) SD

Type HELP for help.

The Bank of the River Styx
Here you are on the gritty beach at the edge of the famous River Styx. The water flows sluggishly by.

You can see Charon's ferry and Charon here.

>talk to charon
You start trying to speak, but there's something in your mouth. Perhaps you should spit it out.

>open mouth
You open your mouth and neatly catch the small coin that drops out.

>talk to charon
Before you can get a word in, Charon monotones, "And you are?"

You realise you don't know and fall silent.

* * *

>0
That's not a verb I recognise.

>talk to charon
Charon looks at you gloomily.

1) "Hi..." 
2) "Uh, bye..." 
(or 0 to say nothing)
>

>1
Charon says nothing.

1) "Uh, bye..." 
(or 0 to say nothing)
>

>1
Charon smirks.

* * *

>talk to charon
Before you can get a word in, Charon monotones, "And you are?"

You realise you don't know and fall silent.

>1
Charon says nothing.

1) "Uh, bye..." 
>

>1
Charon smirks.

* * *

>talk to charon
Before you can get a word in, Charon monotones, "And you are?"

You realise you don't know and fall silent.

>get in boat
You haven't paid.

>give obol to charon
Charon looks at you wearily, "There's nothing to pay for until you tell me who you are." (Maybe you should talk to him first?)

>talk to Charon
Before you can get a word in, Charon monotones, "And you are?"

You realise you don't know and fall silent.

>x clipboard
Charon irritably angles the clipboard away from you, but not before you've seen the list of names he's expecting for the trip across the river:

Sisyphus
Tantalus
Prometheus
Danaids
Zeno

* * *

>talk to charon
Before you can get a word in, Charon monotones, "And you are?"

Recalling the list of names on the clipboard, you say:

1) "I'm Sisyphus!"

2) "Never mind..." 
>

>1
Charon raises his eyebrow, "Oh yeah? Sure thing. Give me the coin.". 

He gestures impatiently with a bony hand.

>pay charon
Charon looks at you wearily, "There's nothing to pay for until you tell me who you are." (Maybe you should talk to him first?)

* * *

>talk to charon
Before you can get a word in, Charon monotones, "And you are?"

You realise you don't know and fall silent.

>tell charon about life
Charon rolls his eyes. "Who are you, exactly?"

>test sisyphus
(Testing.)

>[1] open mouth
It's open already, and you've never looked better.

>[2] x clipboard
Charon irritably angles the clipboard away from you, but not before you've seen the list of names he's expecting for the trip across the river:

Sisyphus
Tantalus
Prometheus
Danaids
Zeno

>[3] talk to charon
Before you can get a word in, Charon monotones, "And you are?"

Recalling the list of names on the clipboard, you say:

1) "I'm Sisyphus!"

2) "Never mind..." 
>> [4] 1
Charon raises his eyebrow, "Oh yeah? Sure thing. Give me the coin.". 

He holds out a bony hand.

>[5] pay charon
You hand over the small coin. Charon drops it into a pocket and gestures at the ferry. "Looks like we're in business. Get in."

>[6] get into boat
Charon is seemingly at pains not to help you step into the ferry. Once you're established, he climbs in after you.

>tell charon about life
Charon holds up a palm. "Save it."

>ask charon about life
Charon looks at you coldly. "None of your business."

All aboard!

* * *

>talk to charon
Before you can get a word in, Charon monotones, "And you are?"

You realise you don't know and fall silent.

>x charon
Charon is leaning against his ferry. His eyes look sourly out from beneath a cowl. He is holding a clipboard.

>x clipboard
Charon irritably angles the clipboard away from you, but not before you've seen the list of names he's expecting for the trip across the river:

Sisyphus
Tantalus
Prometheus
Danaids
Zeno

>talk to charon
Charon looks at you gloomily.

You say:

1) "Uh, hi..."

2) "Never mind..." 
>

* * *

>talk to charon
Before you can get a word in, Charon monotones, "And you are?"

You realise you don't know and fall silent.

>x clipboard
Charon irritably angles the clipboard away from you, but not before you've seen the list of names he's expecting for the trip across the river:

Sisyphus
Tantalus
Prometheus
Danaids
Zeno

* * *

>1
Charon raises his eyebrow, "Oh yeah? Sure thing. Give me the coin.". 

He holds out a bony hand.

>talk to charon
Charon isn't interested in talking to you about anything. Ever.

>tell charon about life
Charon holds up a palm. "Save it."

>ask charon about boat
Charon looks at you with disinterest, then stops looking at you with equal disinterest

* * *

>talk to charon
You start trying to speak, but there's something in your mouth. Perhaps you should spit it out.

>talk charon
That's not a verb I recognise.

>tell charon about the yankees
Charon smirks.

>talk charon
That's not a verb I recognise.

* * *

>talk to charon
You start trying to speak, but there's something in your mouth. Perhaps you should spit it out.

>talk to charon about cats
That's not a verb I recognise.

>tell charon
I didn't understand that sentence.

>tell charon about cats
Charon rolls his eyes. "Who are you, exactly?"

* * *

>talk to charon
You start trying to speak, but there's something in your mouth. Perhaps you should spit it out.

>talk to charon about fish
I only understood you as far as wanting to talk to Charon.

>ask charon about fish
Charon sniffs, "And you are?"

>tell charon about coin
Charon rolls his eyes. "Who are you, exactly?"

* * *

>talk to charon
You start trying to speak, but there's something in your mouth. Perhaps you should spit it out.

>talk to charon about myself
I only understood you as far as wanting to talk to Charon.

* * *

>talk to charon
You start trying to speak, but there's something in your mouth. Perhaps you should spit it out.

>x mouth
You purse your lips and can just make them out while staring strenuously downward. As you do, you feel something in your mouth.

>look in mouth
You can't see inside, since your mouth is closed.

>open mouth
You open your mouth and neatly catch the small coin that drops out.

>look in mouth
your mouth is empty.

>close mouth
Good idea.

* * *

>open mouth
Let's not. You shouldn't just stand around with your mouth open, you know.

>x coin
A small silver coin imprinted with the blurry image of a sleepy man's face.

>drop coin
Dropped.

>get coin
Taken.

>throw coin
Dropped.

>get coin
Taken.

>throw coin at charon
You lack the nerve when it comes to the crucial moment.

>x me
As good-looking as ever.

>kiss charon
Charon might not like that.

>kiss me
You don't get much from that.

>get charon
I don't suppose Charon would care for that.

>get me
You are always self-possessed.

>drop charon
Charon is already here.

>lick charon
That's not a verb I recognise.

>taste charon
You taste nothing unexpected.

>taste me
You taste nothing unexpected.

* * *

>x mouth
You purse your lips and can just make them out while staring strenuously downward. As you do, you feel something in your mouth.

>open mouth
You open your mouth and neatly catch the small coin that drops out.

* * *

>i
You are carrying:
  an obol

>x obol
A small silver coin imprinted with the blurry image of a sleepy man's face.

* * *

Let's Play: Ancient Greek Punishment: The Text Adventure
An Interactive Fiction by Pippin Barr
Release 1 / Serial number 190624 / Inform 7 build 6M62 (I6/v6.33 lib 6/12N) SD

Type HELP for help.

The Bank of the River Styx
Here you are on the gritty beach at the edge of the famous River Styx. The water flows sluggishly by.

You can see Charon's ferry and Charon here.

>talk to charon about cats
You can't see any such thing.

>talk to charon about ferry
Charon coughs.

* * *

Let's Play: Ancient Greek Punishment: The Text Adventure
An Interactive Fiction by Pippin Barr
Release 1 / Serial number 190624 / Inform 7 build 6M62 (I6/v6.33 lib 6/12N) SD

Type HELP for help.

The Bank of the River Styx
Here you are on the gritty beach at the edge of the famous River Styx. The water flows sluggishly by.

You can see Charon's ferry and Charon here.

>talk to charon about dogs
I only understood you as far as wanting to talk to Charon.

* * *

Let's Play: Ancient Greek Punishment: The Text Adventure
An Interactive Fiction by Pippin Barr
Release 1 / Serial number 190624 / Inform 7 build 6M62 (I6/v6.33 lib 6/12N) SD

Type HELP for help.

The Bank of the River Styx
Here you are on the gritty beach at the edge of the famous River Styx. The water flows sluggishly by.

You can see Charon's ferry and Charon here.

>tantalus
You utter the magical words and the world seems to shudder on its axis, blurring everything for a moment. When you adjust your vision, your surroundings have changed.

A Desolate Beach (in the pool)
An apple tree extends its branches above a clear pool of water set back on the beach from the river's edge. A single apple hangs from a single branch.

You're so hungry.

>x note
Which do you mean, the the red post-it note stuck to the apple or the the blue post-it note floating in the pool?

I beg your pardon?

>x pool
Crystal clear, eminently drinkable water. There is a blue post-it note floating on the surface.

You're starving.

>x note
Which do you mean, the the red post-it note stuck to the apple or the blue post-it note?

* * *

>tantalus
You utter the magical words and the world seems to shudder on its axis, blurring everything for a moment. When you adjust your vision, your surroundings have changed.

A Desolate Beach (in the pool)
An apple tree extends its branches above a clear pool of water set back on the beach from the river's edge. A single apple hangs from a single branch.

You're so hungry.

>x post-it
Which do you mean, the  or the the blue post-it note floating in the pool?

>stuck to the apple
You can't see any such thing.

>red
That's not a verb I recognise.

>x post-it
Which do you mean, the the red post-it note stuck to the apple or the the blue post-it note floating in the pool?

>red
The note on the apple says

Eat me.

Just after you finish reading it, the post-it note blows off the apple and away into the distance.

Your stomach gurgles.

>x post-it
The note floating in the water says

Drink me.

After you read it, the post-it note is plucked from the water by a gust of wind and flaps wetly into the distance.

You wish you had something to drink.

>x post-it
You can't see any such thing.

>restart
Are you sure you want to restart?

>y
Let's Play: Ancient Greek Punishment: The Text Adventure
An Interactive Fiction by Pippin Barr
Release 1 / Serial number 190624 / Inform 7 build 6M62 (I6/v6.33 lib 6/12N) SD

Type HELP for help.

The Bank of the River Styx
Here you are on the gritty beach at the edge of the famous River Styx. The water flows sluggishly by.

You can see Charon's ferry and Charon here.

>tantalus
You utter the magical words and the world seems to shudder on its axis, blurring everything for a moment. When you adjust your vision, your surroundings have changed.

A Desolate Beach (in the pool)
An apple tree extends its branches above a clear pool of water set back on the beach from the river's edge. A single apple hangs from a single branch.

You're starving.

>x post-it
Which do you mean, the the red post-it note stuck to the apple or the the blue post-it note floating in the pool?

>x apple
A shiny, delicious apple just begging to be eaten. There is a red post-it note stuck to the apple.

Your stomach hurts with hunger.

>x post-it
Which do you mean, the the red post-it note stuck to the apple or the the blue post-it note floating in the pool?

>x pool
Crystal clear, eminently drinkable water. There is a blue post-it note floating on the surface.

You wish you had something to drink.

>x post-it
Which do you mean, the red post-it note or the blue post-it note?

* * *

Let's Play: Ancient Greek Punishment: The Text Adventure
An Interactive Fiction by Pippin Barr
Release 1 / Serial number 190624 / Inform 7 build 6M62 (I6/v6.33 lib 6/12N) SD

Type HELP for help.

The Bank of the River Styx
Here you are on the gritty beach at the edge of the famous River Styx. The water flows sluggishly by.

You can see Charon's ferry and Charon here.

>taste me
Nothing tastes of anything in Hades.

* * *

Let's Play: Ancient Greek Punishment: The Text Adventure
An Interactive Fiction by Pippin Barr
Release 1 / Serial number 190624 / Inform 7 build 6M62 (I6/v6.33 lib 6/12N) SD

Type HELP for help.

The Bank of the River Styx
Here you are on the gritty beach at the edge of the famous River Styx. The water flows sluggishly by.

You can see Charon's ferry and Charon here.

>taste obol
You can't see any such thing.

>open mouth
You open your mouth and neatly catch the small coin that drops out.

>taste obol
The obol has spent plenty of time in your mouth already.

* * *

Let's Play: Ancient Greek Punishment: The Text Adventure
An Interactive Fiction by Pippin Barr
Release 1 / Serial number 190624 / Inform 7 build 6M62 (I6/v6.33 lib 6/12N) SD

Type HELP for help.

The Bank of the River Styx
Here you are on the gritty beach at the edge of the famous River Styx. The water flows sluggishly by.

You can see Charon's ferry and Charon here.

>tell charon about my great new idea
Charon rolls his eyes. "Who are you, exactly?"

* * *

Let's Play: Ancient Greek Punishment: The Text Adventure
An Interactive Fiction by Pippin Barr
Release 1 / Serial number 190624 / Inform 7 build 6M62 (I6/v6.33 lib 6/12N) SD

Type HELP for help.

The Bank of the River Styx
Here you are on the gritty beach at the edge of the famous River Styx. The water flows sluggishly by.

You can see Charon's ferry and Charon here.

>tell charon about poops
This provokes no reaction.

* * *

Let's Play: Ancient Greek Punishment: The Text Adventure
An Interactive Fiction by Pippin Barr
Release 1 / Serial number 190624 / Inform 7 build 6M62 (I6/v6.33 lib 6/12N) SD

Type HELP for help.

The Bank of the River Styx
Here you are on the gritty beach at the edge of the famous River Styx. The water flows sluggishly by.

You can see Charon's ferry and Charon here.

>test danaid
(Testing.)

>[1] open mouth
You open your mouth and neatly catch the small coin that drops out.

>[2] x clipboard
Charon irritably angles the clipboard away from you, but not before you've seen the list of names he's expecting for the trip across the river:

Sisyphus
Tantalus
Prometheus
Danaids
Zeno

>[3] talk to charon
Before you can get a word in, Charon monotones, "And you are?"

Recalling the list of names on the clipboard, you say:

1) "I'm Sisyphus!"

2) "I'm Tantalus!"

3) "I'm Prometheus!"

4) "I'm a Danaid!"

5) "I'm Zeno!"

6) "Never mind..." 
>> [4] 4
Charon looks at you blankly, "Sure. Pay me.". 

He holds out a bony hand.

>[5] pay charon
You hand over the small coin. Charon drops it into a pocket and gestures at the ferry. You should probably get in.

>[6] get in
Charon takes pains not to help you step into the ferry, but you make it in alright.

Charon sets about unmooring the ferry.

>[7] z
Time passes.

Charon steps deftly into the ferry and takes up his position at the oars.

>[8] z
Time passes.

With a series of surprisingly muscular pulls on the oars, Charon sends the ferry across the river. You barely have time to take in the gloomy fog and lack of scenery before the prow of the boat grinds onto the gritty sand of a beach.

Charon looks at you implacably. You intuit that it's time for you to get out.

>[9] get out
You manage to jump out of the ferry clumsily.

Before he departs, Charon mentions you can get to your punishment faster by just announcing yourself immediately, such as saying "My name is Danaid." His duty discharged, Charon oars away without giving you a another thought.

>l
An Arid Beach
The sand here is bone dry. Rising out of the ground is a fountain and a little distance from it is a basin.

You can see a jug here.

>x sand
(the sand)
Coulr this be literally crushed up bones?

>x beach
Apparently death is a beach, too. Not much of a beach day, though.

>x fountain
(the fountain)
A small fountain perpetually shooting water a short way up into the air before it cascades down into a shallow bowl and drains out.

>x water
Cool, clear water.

>x jug
An earthenware jug with a handle. It's empty.

>x handle
Looks sturdy.

>x basin
(the basin)
A wide basin intended for holding liquid. Let's say water. There is a white post-it note stuck to the rim.

>read post-it
The note says

Fill me.

Just after you finish reading it, the post-it note blows off the rim of the basin and away into the distance.

>get note
You can't see any such thing.

>x basin
(the basin)
A wide basin intended for holding liquid. Let's say water.

>x rim of basin
That's a quality rim.

>get jug
Taken.

* * *

>fill basin
(the basin)
You carefully pour the water in the jug into the basin. It streams in nicely, catching what little light there is.

>x basin
(the basin)
A wide basin intended for holding liquid. About a jug's-worth of water is in it right now.

The water in the basin drains out through several holes with a bubbling noise that sounds like Zeus's laughter. The escaped water immediately dissapates into the sand.

>x basin
(the basin)
A wide basin intended for holding liquid. Let's say water. There are holes drilled in the bottom.

* * *

>x fountain
(the fountain)
A small fountain perpetually shooting water a short way up into the air before it cascades down into a shallow bowl and drains out.

>x bowl
It is etched with images of frowning faces.

>x shallow bowl
You can't see any such thing.

>x frowning faces
They don't look happy with you. Somehow you know it's you.

>pour jug
You tip the empty jug and pour pretend water out of it. It's still empty afterwards.

>put water in basin
(the basin)
The jug is empty.

>get water
You fill the jug with water from the fountain.

>put water in basin
(the basin)
You carefully pour the water in the jug into the basin. It streams in nicely, catching what little light there is.

>get water
You fill the jug with water from the fountain.

The water in the basin drains out through several holes with a bubbling noise that sounds like Zeus's laughter. The escaped water immediately dissapates into the sand.

>x fountain
(the fountain)
A small fountain perpetually shooting water a short way up into the air before it cascades down into a shallow bowl and drains out.

* * *

>get water
There's already water in the jug.

>fill fountain
(the fountain)
You carefully pour the water in the jug into the fountain, thereby achieving slightly less than nothing.

>pour fountain into basin
(the fountain into the basin)
You won't be needing to do that.

* * *

Let's Play: Ancient Greek Punishment: The Text Adventure
An Interactive Fiction by Pippin Barr
Release 1 / Serial number 190624 / Inform 7 build 6M62 (I6/v6.33 lib 6/12N) SD

Type HELP for help.

The Bank of the River Styx
Here you are on the gritty beach at the edge of the famous River Styx. The water flows sluggishly by.

You can see Charon's ferry and Charon here.

>test prometheus
(Testing.)

>[1] open mouth
You open your mouth and neatly catch the small coin that drops out.

>[2] x clipboard
Charon irritably angles the clipboard away from you, but not before you've seen the list of names he's expecting for the trip across the river:

Sisyphus
Tantalus
Prometheus
Danaids
Zeno

>[3] talk to charon
Before you can get a word in, Charon monotones, "And you are?"

Recalling the list of names on the clipboard, you say:

1) "I'm Sisyphus!"

2) "I'm Tantalus!"

3) "I'm Prometheus!"

4) "I'm a Danaid!"

5) "I'm Zeno!"

6) "Never mind..." 
>> [4] 3
Charon looks at you blankly, "Sure. Pay me.". 

He holds out a bony hand.

>[5] pay charon
You hand over the small coin. Charon drops it into a pocket and gestures at the ferry. You should probably get in.

>[6] get in
Charon takes pains not to help you step into the ferry, but you make it in alright.

Charon sets about unmooring the ferry.

>[7] z
Time passes.

Charon steps deftly into the ferry and takes up his position at the oars.

>[8] z
Time passes.

With a series of surprisingly muscular pulls on the oars, Charon sends the ferry across the river. You barely have time to take in the gloomy fog and lack of scenery before the prow of the boat grinds onto the gritty sand of a beach.

Charon looks at you implacably. You intuit that it's time for you to get out.

>[9] get out
You manage to jump out of the ferry clumsily.

Charon jumps lightly out of the ferry behind you and leads to you the imposing black rock embedded in the beach. With his guidance you lie down on top of it and Charon chains you securely in place. This done, he descends from the rock and returns to the ferry.

The Rock (chained to the rock)
Beneath what passes for daylight here, an unpleasantly jagged black rock rises from the ash colored sand of the beach. You are chained to the rock. There is a grey post-it note stuck just next to your head.

You can see Charon and Charon's ferry here.

Before he departs, Charon mentions you can get to your punishment faster by just announcing yourself immediately, such as saying "My name is Prometheus." His duty discharged, Charon oars away without giving you a another thought.

>l
The Rock (on the Rock)
A unpleasantly jagged black rock rises from the ash colored sand of the beach. You are chained to said rock.

* * *

>writhe
You twist experimentally. Nothing obvious happens.

An eagle appears on the horizon.

>wait
Time passes.

The eagle is getting close.

>wait
Time passes.

The eagle is right above you.

>twist
You thrash in desperately. It's enough to prevent the eagle from landing.

>thrash
You writhe in desperately. It's enough to prevent the eagle from landing.

>look at eagle
It looks irritable.

The eagle lands heavily beside you. You feel an urge to struggle.

>struggle
You writhe in desperately. It's enough to disturb the eagle, which flaps up into the air.

* * *

>x moon
You can't see it.

An eagle appears on the horizon.

>x fog
It makes you feel distinctly less happy.

The eagle is getting close.

>x sun
A sun-coloured patch of fog.

The eagle is right above you.

>x chains
The chains are weirdly yellow in colour. They definitely work though.

The eagle lands heavily beside you. You feel an urge to thrash.

>thrash
You twist in place desperately. It's enough to disturb the eagle, which flaps up into the air.

>thrash
You writhe in place desperately. It's enough to disturb the eagle, which flaps up into the air.

>get up
You are tightly chained to the rock, you're not going anywhere. At best you could writhe, struggle, strain, or something like that.

The eagle lands heavily beside you. You feel an urge to struggle.

* * *

Let's Play: Ancient Greek Punishment: The Text Adventure
An Interactive Fiction by Pippin Barr
Release 1 / Serial number 190624 / Inform 7 build 6M62 (I6/v6.33 lib 6/12N) SD

Type HELP for help.

The Bank of the River Styx
Here you are on the gritty beach at the edge of the famous River Styx. The water flows sluggishly by.

You can see Charon's ferry and Charon here.

>test sisyphgus
>--> The following tests are available:
'test sisyphus'

>test sisyphus
(Testing.)

>[1] open mouth
You open your mouth and neatly catch the small coin that drops out.

>[2] x clipboard
Charon irritably angles the clipboard away from you, but not before you've seen the list of names he's expecting for the trip across the river:

Sisyphus
Tantalus
Prometheus
Danaids
Zeno

>[3] talk to charon
Before you can get a word in, Charon monotones, "And you are?"

Recalling the list of names on the clipboard, you say:

1) "I'm Sisyphus!"

2) "Never mind..." 
>> [4] 1
Charon raises his eyebrow, "Oh yeah? Sure thing. Give me the coin.". 

He holds out a bony hand.

>[5] pay charon
You hand over the small coin. Charon drops it into a pocket and gestures at the ferry. "Looks like we're in business. Get in."

>[6] get into boat
Charon is seemingly at pains not to help you step into the ferry. Once you're established, he climbs in after you.

>z
Time passes.

>z
Time passes.

All aboard!

>z
Time passes.

>test sisyphus
(Testing.)

>[1] open mouth
It's open already, and you've never looked better.

>[2] x clipboard
Charon irritably angles the clipboard away from you, but not before you've seen the list of names he's expecting for the trip across the river:

Sisyphus
Tantalus
Prometheus
Danaids
Zeno

>[3] talk to charon
Before you can get a word in, Charon monotones, "And you are?"

Recalling the list of names on the clipboard, you say:

1) "I'm Sisyphus!"

2) "Never mind..." 
>> [4] 1
Charon raises his eyebrow, "Oh yeah? Sure thing. Give me the coin.". 

He holds out a bony hand.

>[5] pay charon
You don't have any money.

>[6] get into boat
Charon is seemingly at pains not to help you step into the ferry. Once you're established, he climbs in after you.

But you're already in Charon's ferry.

* * *

Let's Play: Ancient Greek Punishment: The Text Adventure
An Interactive Fiction by Pippin Barr
Release 1 / Serial number 190624 / Inform 7 build 6M62 (I6/v6.33 lib 6/12N) SD

Type HELP for help.

The Bank of the River Styx
Here you are on the gritty beach at the edge of the famous River Styx. The water flows sluggishly by.

You can see Charon's ferry and Charon here.

>test sisyphus
(Testing.)

>[1] open mouth
You open your mouth and neatly catch the small coin that drops out.

>[2] x clipboard
Charon irritably angles the clipboard away from you, but not before you've seen the list of names he's expecting for the trip across the river:

Sisyphus
Tantalus
Prometheus
Danaids
Zeno

>[3] talk to charon
Before you can get a word in, Charon monotones, "And you are?"

Recalling the list of names on the clipboard, you say:

1) "I'm Sisyphus!"

2) "I'm Tantalus!"

3) "I'm Prometheus!"

4) "I'm a Danaid!"

5) "I'm Zeno!"

6) "Never mind..." 
>> [4] 1
Charon looks at you blankly, "Sure. Pay me.". 

He holds out a bony hand.

>[5] pay charon
You hand over the small coin. Charon drops it into a pocket and gestures at the ferry. You should probably get in.

>1
Charon raises his eyebrow, "Oh yeah? Sure thing. Give me the coin.". 

He gestures impatiently with a bony hand.

>give coin to charon
You can't see any such thing.

>give obol to charon
Charon doesn't seem interested.

* * *

>enter ferry
Charon narrows his eyes and it's enough to stop you in your tracks.

Charon oars away without giving you a second thought.

* * *

>get in
Charon takes pains not to help you step into the ferry, but you make it in alright.

Charon sets about unmooring the ferry.

>z
Time passes.

Charon steps deftly into the ferry and takes up his position at the oars.

I beg your pardon?

>z
Time passes.

With a series of surprisingly muscular pulls on the oars, Charon sends the ferry across the river. You barely have time to take in the gloomy fog and lack of scenery before the prow of the boat grinds onto the gritty sand of a beach.

Charon looks at you implacably. You intuit that it's time for you to get out.

>get out
You manage to jump out of the ferry clumsily.

Before he departs, Charon mentions you can get to your punishment faster by just announcing yourself immediately, such as saying "My name is Sisyphus." His duty discharged, Charon oars away without giving you a another thought.

>up
A Little Way Up the Hill
Just above the beach the grit-sand turns into a packed dirt of the same colour. The occasional sprig of dead grass serves to liven it up.

>up
Partway Up the Hill
The hill slopes up and down away from you, formidable in its general featurelessness. It looks like you're exactly half-way up. Or down.

You can see a swan here.

>up
A Fair Way Up the Hill
A continuation of this relentless expanse of hillside. There seems to be a small hole in the dirt.

>up
Quite Far Up the Hill
Far enough up the hill to be out of breath if you don't get out much. Like the rest of the hill, this part is made entirely out of dirt.

You can see a videogame here.

>up
Nearly the Top of the Hill
It's so barren up here you can't even imagine something growing, and you have a pretty good imagination. The fog, however, does appear to be coalescing into strange shapes here.

>x fog
The swirling fog almost looks like a bed.

>x fog
The swirling fog almost looks like Albert Camus.

>down
Quite Far Up the Hill
Like the rest of the hill, this part is made entirely out of dirt.

>restart
Are you sure you want to restart?

>y
Let's Play: Ancient Greek Punishment: The Text Adventure
An Interactive Fiction by Pippin Barr
Release 1 / Serial number 190620 / Inform 7 build 6M62 (I6/v6.33 lib 6/12N) SD

Type HELP for help.

The Bank of the River Styx
Here you are on the gritty beach at the edge of the famous River Styx. The water flows sluggishly by.

You can see Charon's ferry and Charon here.

>test sisyphus
(Testing.)

>[1] open mouth
You open your mouth and neatly catch the small coin that drops out.

>[2] x clipboard
Charon irritably angles the clipboard away from you, but not before you've seen the list of names he's expecting for the trip across the river:

Sisyphus
Tantalus
Prometheus
Danaids
Zeno

>[3] talk to charon
Before you can get a word in, Charon monotones, "And you are?"

Recalling the list of names on the clipboard, you say:

1) "I'm Sisyphus!"

2) "I'm Tantalus!"

3) "I'm Prometheus!"

4) "I'm a Danaid!"

5) "I'm Zeno!"

6) "Never mind..." 
>> [4] 1
Charon looks at you blankly, "Sure. Pay me.". 

He holds out a bony hand.

>[5] pay charon
You hand over the small coin. Charon drops it into a pocket and gestures at the ferry. You should probably get in.

* * *

>z
Time passes.

Charon steps deftly into the ferry and takes up his position at the oars.

>z
Time passes.

With a series of surprisingly muscular pulls on the oars, Charon sends the ferry across the river. You barely have time to take in the gloomy fog and lack of scenery before the prow of the boat grinds onto the gritty sand of a beach.

Charon looks at you implacably. You intuit that it's time for you to get out.

* * *

>up
Quite Far Up the Hill
Far enough up the hill to be out of breath if you don't get out much. Like the rest of the hill, this part is made entirely out of dirt.

You can see a videogame here.

>x videogame
You can't see any such thing.

>l
Quite Far Up the Hill
Far enough up the hill to be out of breath if you don't get out much. Like the rest of the hill, this part is made entirely out of dirt.

* * *

>up
A Little Way Up the Hill
Just above the beach the grit-sand turns into a packed dirt of the same colour. The occasional sprig of dead grass serves to liven it up.

>x note
It's too far away.

>x boulder
That really is a lot of rock. At least it looks a bit smaller from up here.

>x beach
Apparently death is a beach, too. Not much of a beach day, though.

>x river
The river seems to sneer at you.

* * *

>x sneer
What an unpleasant river.

>read note
It's too far away.

>get note
It's too far away.

>get boulder
It's too far away.

>d
Bottom of the Hill
A grey, gritty beach meets the edge of the river. A low, bare hill rises gently upward.

You can see a worryingly large boulder here.

>get boulder
That would be hilarious, but it's too big, too heavy, and too destined to punish you for that.

* * *

>up
A Fair Way Up the Hill
A continuation of this relentless expanse of hillside. There seems to be a small hole in the dirt.

>x hole
A small absence of dirt amidst the dirt.

In the hole is a folded note.

>get note
(the folded note)
Taken.

>read note
(the folded note)
The note has just one word on it:

xyzzy

The note blows sharply out of your hand and off into the distance.

>xyzzy
Nothing happens. Magic isn't real. You could swear you can hear Zeus chuckling somewhere just out of view.

>drop note
It's too far away.

>x note
The note just says

Push me.

The post-it note suddenly tears off the boulder in a gust of wind and loops madly away into the distance.

>l
A Fair Way Up the Hill
A continuation of this relentless expanse of hillside. There seems to be a small hole in the dirt.

>x note
You can't see any such thing.

* * *

>get out
Charon oars away without giving you a second thought.

You get out of Charon's ferry.

Bottom of the Hill
A grey, gritty beach meets the edge of the river. To the north a low, bare hill rises gently upward.

You can see a worryingly large boulder here.

>l
Bottom of the Hill
A grey, gritty beach meets the edge of the river. To the north a low, bare hill rises gently upward.

You can see a worryingly large boulder here.

>x charon
Charon is leaning against his ferry. His eyes look sourly out from beneath a cowl. He is holding a clipboard.

>x ferry
It's Charon's ferry, not totally unlike a small dinghy. Right now it is pulled up onto the bank of the river, ready to shove off into the river.

In Charon's ferry is Charon.

* * *

>get out
Charon oars away without giving you a second thought.

You get out of Charon's ferry.

Bottom of the Hill
A grey, gritty beach meets the edge of the river. To the north a low, bare hill rises gently upward.

You can see a worryingly large boulder here.

>l charon
You can't see any such thing.

>l
Bottom of the Hill
A grey, gritty beach meets the edge of the river. To the north a low, bare hill rises gently upward.

You can see a worryingly large boulder here.

* * *

>l
Bottom of the Hill
A grey, gritty beach meets the edge of the river. To the north a low, bare hill rises gently upward.

You can see a worryingly large boulder here.

>i
You are carrying nothing.

>open mouth
It's open already, and you've never looked better.

* * *

>l
Bottom of the Hill
A grey, gritty beach meets the edge of the river. To the north a low, bare hill rises gently upward.

You can see a worryingly large boulder here.

>restart
Are you sure you want to restart?

* * *

>y
Let's Play: Ancient Greek Punishment: The Text Adventure
An Interactive Fiction by Pippin Barr
Release 1 / Serial number 190606 / Inform 7 build 6M62 (I6/v6.33 lib 6/12N) SD

Bank of the River Styx
Here you are at the famous River Styx. The water flows sluggishly by.

You can see Charon here.

>test sisyphus
(Testing.)

>[1] open mouth
You open your mouth and neatly catch the small coin that drops out.

>[2] x clipboard
Charon irritably angles the clipboard away from you, but not before you've seen the list of names he's expecting for the trip across the river:

Sisyphus
Tantalus
Prometheus
Danaids
Zeno

>[3] talk to charon
Before you can get a word in, Charon monotones, "And you are?"

Recalling the list of names on the clipboard, you say:

Error: no text for Talk to Charon.

1) "I'm Sisyphus!"

2) "Never mind..." 
>> [4] 1
Charon raises his eyebrow, "Oh yeah? Sure thing. Give me the coin.". 

He holds out a bony hand.

>[5] pay charon
You hand over the small coin. Charon drops it into a pocket and gestures at the ferry. "Looks like we're in business. Get in."

>[6] get into boat
Charon is seemingly at pains not to help you step into the ferry. Once you're established, he climbs in after you.

Charon sets about unmooring the ferry.

>[7] z
Time passes.

Charon steps deftly into the ferry and takes up his position at the oars.

>[8] z
Time passes.

With a series of surprisingly muscular pulls on the oars, Charon sends the ferry across the river. You barely have time to take in the gloomy fog and lack of scenery before the prow of the boat grinds onto the rocky sand of a beach.

Charon looks at you implacably. You intuit that it's time for you to get out.

>[9] get out
You get out of Charon's ferry.

Bottom of the Hill
A grey, gritty beach meets the edge of the river. To the north a low, bare hill rises gently upward.

You can see a worryingly large boulder here.

>get into ferry
Charon is seemingly at pains not to help you step into the ferry. Once you're established, he climbs in after you.

Charon narrows his eyes and it's enough to stop you in your tracks.

Charon oars away without giving you a second thought.

* * *

>l charon
Charon is leaning against his ferry. His eyes look sourly out from beneath a cowl. He is holding a clipboard.

* * *

>pay
(Charon)
You've already paid.

>get in
Charon takes pains not to help you step into the ferry, but you make it in alright.

Charon sets about unmooring the ferry.

* * *

>up
A Fair Way Up the Hill
A continuation of this relentless expanse of hillside. There seems to be a small hole in the dirt.

>d
Partway Up the Hill
The hill slopes up and down away from you, formidable in its general featurelessness. It looks like you're exactly half-way up. Or down.

You can see a swan here.

>x swan
As soon as you look directly at the swan, it's not there anymore. Maybe it was a trick of the light.

>l
Partway Up the Hill
The hill slopes up and down away from you, formidable in its general featurelessness. It looks like you're exactly half-way up. Or down.

>up
A Fair Way Up the Hill
A continuation of this relentless expanse of hillside. There seems to be a small hole in the dirt.

* * *

>up
Quite Far Up the Hill
Far enough up the hill to be out of breath if you don't get out much. Like the rest of the hill, this part is made entirely out of dirt.

>x book
You can't see any such thing.

>get book
You can't see any such thing.

>down
A Fair Way Up the Hill
A continuation of this relentless expanse of hillside. There seems to be a small hole in the dirt.

>down
Partway Up the Hill
The hill slopes up and down away from you, formidable in its general featurelessness. It looks like you're exactly half-way up. Or down.

>down
A Little Way Up the Hill
Just above the beach the grit-sand turns into a packed dirt of the same colour. The occasional sprig of dead grass serves to liven it up.

>down
Bottom of the Hill
A grey, gritty beach meets the edge of the river. A low, bare hill rises gently upward.

You can see a worryingly large boulder here.

* * *

>push
(the worryingly large boulder)
You furrow your brow and heave the boulder forward.

Quite Far Up the Hill
Far enough up the hill to be out of breath if you don't get out much. Like the rest of the hill, this part is made entirely out of dirt.

>x book
You can't see any such thing.

* * *

>get book
You can't see any such thing.

>up
Nearly the Top of the Hill
It's so barren up here you can't even imagine something growing, and you have a pretty good imagination.

Obeying gravity, the boulder rolls calmly down the hill.

>up
The Top of the Hill
The view is disappointing, with just the river below and everywhere a thick blanket of fog that prevents you seeing far in any direction. You should really go get the boulder.

You can see a plinth (on which is a book) here.

The boulder rolls down the hill.

>x plinth
A minimalist marble plinth.

On the plinth is a book.

The boulder rolls down the hill.

>x book
It's "The Myth of Sisyphus" by Albert Camus. Apparently you ought to be happy right now. The book is chained to the plinth.

The boulder rolls down the hill.

Below, you see the boulder settle into place at the bottom of the hill.

>get book
It's chained to the plinth.

>read book
It's "The Myth of Sisyphus" by Albert Camus. Apparently you ought to be happy right now. The book is chained to the plinth.

* * *

>s
You can't go that way.

* * *

>n
You can't go that way.

>w
You can't go that way.

* * *

>e
You can't go that way.

>push boulder n
You can't go that way.

>push boulder
Nothing obvious happens.

>push boulder up hill
I only understood you as far as wanting to push the worryingly large boulder up.

* * *

>w
You can't go that way.

>get in
Charon takes pains not to help you step into the ferry, but you make it in alright.

Charon sets about unmooring the ferry.

>w
You're still in the ferry. You should get out first.

Charon steps deftly into the ferry and takes up his position at the oars.

>n
You're still in the ferry. You should get out first.

With a series of surprisingly muscular pulls on the oars, Charon sends the ferry across the river. You barely have time to take in the gloomy fog and lack of scenery before the prow of the boat grinds onto the rocky sand of a beach.

Charon looks at you implacably. You intuit that it's time for you to get out.

>run n
You're still in the ferry. You should get out first.

>get out
You manage to jump out of the ferry clumsily.

Before he departs, Charon mentions you can get to your punishment faster by just announcing yourself immediately, such as saying "My name is Sisyphus." His duty discharged, Charon oars away without giving you a another thought.

>help
This is a work of interactive fiction and tries to follow standard ways of existing in a textual world: 

 To look at where you are type LOOK. 
 To look at something specific type LOOK AT THING or EXAMINE THING. 
 To pick something up type GET THING or TAKE THING. 
 To talk to someone type TALK TO PERSON. 
 To go somewhere type a direction like NORTH or UP.

Generally speaking, look at everything you can and then work out what to do from there.

* * *

>z
Time passes.

Charon steps deftly into the ferry and takes up his position at the oars.

>l
Bank of the River Styx (in Charon's ferry)
Here you are at the famous River Styx. The water flows sluggishly by.

In Charon's ferry you can see Charon.

All aboard!

* * *

>z
Time passes.

Charon steps deftly into the ferry and takes up his position at the oars.

>z
Time passes.

With a series of surprisingly muscular pulls on the oars, Charon sends the ferry across the river. You barely have time to take in the gloomy fog and lack of scenery before the prow of the boat rises onto the gritty sand of a beach.

Charon looks at you implacably. You intuit that it's time for you to get out.

>l
Bottom of the Hill (in Charon's ferry)
A level area meets the edge of the river, then rises gently upward to the north.

You can see a worryingly large boulder here.

In Charon's ferry you can see Charon.

* * *

>z
Time passes.

With a series of surprisingly muscular pulls on the oars, Charon sends the ferry across the river. You barely have time to take in the gloomy fog and lack of scenery before the prow of the boat rises onto the gritty sand of a beach.

Charon looks at you implacably. You intuit that it's time for you to get out.

>z
Time passes.

>l
Bottom of the Hill (in Charon's ferry)
You're standing at the bottom of a low hill. The slope is fairly gentle.

In Charon's ferry you can see Charon.

* * *

Let's Play: Ancient Greek Punishment: The Text Adventure
An Interactive Fiction by Pippin Barr
Release 1 / Serial number 190624 / Inform 7 build 6M62 (I6/v6.33 lib 6/12N) SD

Type HELP for help.

The Bank of the River Styx
Here you are on the gritty beach at the edge of the famous River Styx. The water flows sluggishly by.

You can see Charon's ferry and Charon here.

>test tantalus
(Testing.)

>[1] open mouth
You open your mouth and neatly catch the small coin that drops out.

>[2] x clipboard
Charon irritably angles the clipboard away from you, but not before you've seen the list of names he's expecting for the trip across the river:

Sisyphus
Tantalus
Prometheus
Danaids
Zeno

>[3] talk to charon
Before you can get a word in, Charon monotones, "And you are?"

Recalling the list of names on the clipboard, you say:

1) "I'm Sisyphus!"

2) "I'm Tantalus!"

3) "I'm Prometheus!"

4) "I'm a Danaid!"

5) "I'm Zeno!"

6) "Never mind..." 
>> [4] 2
Charon looks at you blankly, "Sure. Pay me.". 

He holds out a bony hand.

>[5] pay charon
You hand over the small coin. Charon drops it into a pocket and gestures at the ferry. You should probably get in.

>[6] get in
Charon takes pains not to help you step into the ferry, but you make it in alright.

Charon sets about unmooring the ferry.

>[7] z
Time passes.

Charon steps deftly into the ferry and takes up his position at the oars.

>[8] z
Time passes.

With a series of surprisingly muscular pulls on the oars, Charon sends the ferry across the river. You barely have time to take in the gloomy fog and lack of scenery before the prow of the boat grinds onto the gritty sand of a beach.

Charon looks at you implacably. You intuit that it's time for you to get out.

>[9] get out
You manage to jump out of the ferry clumsily.

Charon hops out of the ferry behind you and leads to you the pool a little way up the beach. He points and you wade into the centre of the water. Satisfied you're in position, Charon turns and walks back to the ferry.

A Desolate Beach (in the pool)
An apple tree extends its branches above a clear pool of water set back on the beach from the river's edge. A single apple hangs from a single branch.

You can see Charon's ferry (in which is Charon) here.

You're feeling really thirsty.

Before he departs, Charon mentions you can get to your punishment faster by just announcing yourself immediately, such as saying "My name is Tantalus." His duty discharged, Charon oars away without giving you a another thought.

>l
A Desolate Beach (in the pool)
An apple tree extends its branches above a clear pool of water set back on the beach from the river's edge. A single apple hangs from a single branch.

You're parched.

>get on tree
That's not something you can enter.

You're thirsty.

>climb tree
You recoil from the incredibly sharp bark on the tree.

You're feeling thirsty.

>x tree
Its bark is worse than its bite.

You need to drink something.

>sit on tree
No rest for the wicked.

You need to drink something.

>x tree
Its bark is worse than its bite.

You need to eat something.

>x bark
It's aggressive.

Your stomach gurgles.

>x water
Crystal clear, eminently drinkable water. There is a blue post-it note floating on the surface.

Your mouth is so dry.

>read note
Which do you mean, the red post-it note or the blue post-it note?

>the blue post-it note
The note floating in the water says

Drink me.

After you read it, the post-it note is plucked from the water by a gust of wind and flaps wetly into the distance.

You need to eat something.

>eat apple
You reach up to pluck the apple from its branch, but as you do a gust of wind blows the branch up and away from you. It only resettles when you give up and drop your arm down again. The wind made a sound oddly like Zeus's laughter.

Your mouth is so dry.

>drink water
You stoop to drink some water, but it recedes as fast as you move toward it until the bottom of the pool is completely dry. Upon standing, the water rushes back in up to your waist. The gurgling sound it make sounds oddly like Zeus's laughter.

You're starving.

>leave
Somehow that's not an option.

Your stomach hurts with hunger.

>exit
Somehow that's not an option.

You wish you had something to eat.

>get out
Somehow that's not an option.

You're so hungry.

>x branch
If a tree branch could be said to eye you shiftily, that is what this tree branch is doing.

You feel terribly dehydrated.

>x branches
They're all barren except for the one branch with the apple on it.

You're starving.

>x apple
A shiny, delicious apple just begging to be eaten. There is a red post-it note stuck to the apple.

You're feeling hungry.

>read post-it
The note on the apple says

Eat me.

Just after you finish reading it, the post-it note blows off the apple and away into the distance.

You wish you had something to drink.

* * *

Let's Play: Ancient Greek Punishment: The Text Adventure
An Interactive Fiction by Pippin Barr
Release 1 / Serial number 190624 / Inform 7 build 6M62 (I6/v6.33 lib 6/12N) SD

Type HELP for help.

The Bank of the River Styx
Here you are on the gritty beach at the edge of the famous River Styx. The water flows sluggishly by.

You can see Charon's ferry and Charon here.

>test zeno
(Testing.)

>[1] open mouth
You open your mouth and neatly catch the small coin that drops out.

>[2] x clipboard
Charon irritably angles the clipboard away from you, but not before you've seen the list of names he's expecting for the trip across the river:

Sisyphus
Tantalus
Prometheus
Danaids
Zeno

>[3] talk to charon
Before you can get a word in, Charon monotones, "And you are?"

Recalling the list of names on the clipboard, you say:

1) "I'm Sisyphus!"

2) "I'm Tantalus!"

3) "I'm Prometheus!"

4) "I'm a Danaid!"

5) "I'm Zeno!"

6) "Never mind..." 
>> [4] 5
Charon looks at you blankly, "Sure. Pay me.". 

He holds out a bony hand.

>[5] pay charon
You hand over the small coin. Charon drops it into a pocket and gestures at the ferry. You should probably get in.

>[6] get in
Charon takes pains not to help you step into the ferry, but you make it in alright.

Charon sets about unmooring the ferry.

>[7] z
Time passes.

Charon steps deftly into the ferry and takes up his position at the oars.

>[8] z
Time passes.

With a series of surprisingly muscular pulls on the oars, Charon sends the ferry across the river. You barely have time to take in the gloomy fog and lack of scenery before the prow of the boat grinds onto the gritty sand of a beach.

Charon looks at you implacably. You intuit that it's time for you to get out.

>[9] get out
You manage to jump out of the ferry clumsily.

Charon points you toward the starting line drawn in the sand and you walk obediently over to it.

A Flat Beach (at the starting line)
The beach extends off into the fog. A straight track of about 100 meters has been sketched into the sand leading north away from the river with the starting line closest to the water. You can see a green flag in the distance at the end of the track. You are at the start line.

You can see Charon's ferry (in which is Charon) here.

Before he departs, Charon mentions you can get to your punishment faster by just announcing yourself immediately, such as saying "My name is Zeno." His duty discharged, Charon oars away without giving you a another thought.

>taste flag
It probably tastes like victory, but you can't reach it right now.

>x line
Which do you mean, the starting line or the finish line?

>starting
A line drawn in the sand. A green post-it note rests on the sand near the line.

>read post-it
The note says

Run.

Just after you finish reading it, a gust of wind blows the post-it note along the beach and cartwheeling into the distance.

>run
You'll have to say which compass direction to go in.

>x pole
A green triangle of fabric attached to a pole jammed into the sand at the northern end of the track. It flaps gently in the wind, making a sound not unlike Archimedes's laughter.

>listen to pole
The flag sounds like Archimedes laughing, waggling his eyebrows, and going on about geometric series.

>n
You run furiously and cover half the distance to the flag!

A Flat Beach (on the track)
The beach extends off into the fog. A straight track of about 100 meters has been sketched into the sand leading north away from the river with the starting line closest to the water. You can see a green flag in the distance at the end of the track. You are half-way to the flag.

>n
You run furiously and cover half the distance to the flag!

A Flat Beach (on the track)
The beach extends off into the fog. A straight track of about 100 meters has been sketched into the sand leading north away from the river with the starting line closest to the water. You can see a green flag in the distance at the end of the track. You are three-quarters of the way to the flag.

>n
You run furiously and cover half the distance to the flag!

A Flat Beach (on the track)
The beach extends off into the fog. A straight track of about 100 meters has been sketched into the sand leading north away from the river with the starting line closest to the water. You can see a green flag in the distance at the end of the track. You are seven-eighths of the way to the flag.

>n
You run furiously and cover half the distance to the flag!

A Flat Beach (on the track)
The beach extends off into the fog. A straight track of about 100 meters has been sketched into the sand leading north away from the river with the starting line closest to the water. You can see a green flag in the distance at the end of the track. You are fifteen-sixteenths of the way to the flag.

>n
You run furiously and cover half the distance to the flag!

A Flat Beach (on the track)
The beach extends off into the fog. A straight track of about 100 meters has been sketched into the sand leading north away from the river with the starting line closest to the water. You can see a green flag in the distance at the end of the track. You are thirty-one thirty-seconds of the way to the flag.

>n
You run furiously and cover half the distance to the flag!

A Flat Beach (on the track)
The beach extends off into the fog. A straight track of about 100 meters has been sketched into the sand leading north away from the river with the starting line closest to the water. You can see a green flag in the distance at the end of the track. You are sixty-three sixty-fourths of the way to the flag.

>n
You run furiously and cover half the distance to the flag!

A Flat Beach (on the track)
The beach extends off into the fog. A straight track of about 100 meters has been sketched into the sand leading north away from the river with the starting line closest to the water. You can see a green flag in the distance at the end of the track. You are a hundred and twenty-seven hundred and twenty-eighths of the way to the flag.

>n
You run furiously and cover half the distance to the flag!

A Flat Beach (on the track)
The beach extends off into the fog. A straight track of about 100 meters has been sketched into the sand leading north away from the river with the starting line closest to the water. You can see a green flag in the distance at the end of the track. You are a two hundred and fifty-five two hundred and fifty-sixths of the way to the flag.

>n
You run furiously and cover half the distance to the flag!

A Flat Beach (on the track)
The beach extends off into the fog. A straight track of about 100 meters has been sketched into the sand leading north away from the river with the starting line closest to the water. You can see a green flag in the distance at the end of the track. You are a five hundred and eleven five hundred and twelfths of the way to the flag.

>north walk
I only understood you as far as wanting to (go) north.

>walk north
Races are for running!

>run north
You run furiously and cover half the distance to the flag!

A Flat Beach (on the track)
The beach extends off into the fog. A straight track of about 100 meters has been sketched into the sand leading north away from the river with the starting line closest to the water. You can see a green flag in the distance at the end of the track. You are practically standing on the flag, but not quite.

* * *

Let's Play: Ancient Greek Punishment: The Text Adventure
An Interactive Fiction by Pippin Barr
Release 1 / Serial number 190624 / Inform 7 build 6M62 (I6/v6.33 lib 6/12N) SD

Type HELP for help.

The Bank of the River Styx
Here you are on the gritty beach at the edge of the famous River Styx. The water flows sluggishly by.

You can see Charon's ferry and Charon here.

>tie charon to ferry
With what?

>apologize
That's not a verb I recognise.

>say sorry
(to Charon)
There is no reply.

>sorry
Oh, don't apologise.

* * *

Let's Play: Ancient Greek Punishment: The Text Adventure
An Interactive Fiction by Pippin Barr
Release 1 / Serial number 190624 / Inform 7 build 6M62 (I6/v6.33 lib 6/12N) SD

Type HELP for help.

The Bank of the River Styx
Here you are on the gritty beach at the edge of the famous River Styx. The water flows sluggishly by.

You can see Charon's ferry and Charon here.

>touch me
No touching!

>kiss charon
Hades has a strict no-kissing policy.

* * *

>touch me
No touching!

>touch charon
No touching!

>touch coin
You can't see any such thing.

>open mouth
You open your mouth and neatly catch the small coin that drops out.

>touch mouth
No touching!

>touch coin
No touching!

>x mouth
You purse your lips and can just make them out while staring strenuously downward. As you do, you feel something in your mouth.

>smell mouth
A faint aroma of crushed bones.

>taste mouth
Nothing tastes of anything in Hades.

>eat coin
That's plainly inedible.

>eat charon
He's plainly inedible.

>search here
You can't see any such thing.

>search mouth
your mouth is empty.

>search charon
You find nothing of interest.

>search ferry
Charon's ferry is empty.

>look under ferry
You find nothing of interest.

>lock ferry
(with the obol)
That doesn't seem to be something you can lock.

>open ferry
It isn't something you can open.

>wear obol
You can't wear that!

>show obol to charon
Charon is unimpressed.

* * *

Let's Play: Ancient Greek Punishment: The Text Adventure
An Interactive Fiction by Pippin Barr
Release 1 / Serial number 190624 / Inform 7 build 6M62 (I6/v6.33 lib 6/12N) SD

Type HELP for help.

The Bank of the River Styx
Here you are on the gritty beach at the edge of the famous River Styx. The water flows sluggishly by.

You can see Charon's ferry and Charon here.

>up
You can't go that way.

>up
You can't go that way.

>sisyphus
Bottom of the Hill
A grey, gritty beach meets the edge of the river. A low, bare hill rises gently upward.

You can see a worryingly large boulder here.

>up
A Little Way Up the Hill
Just above the beach the grit-sand turns into a packed dirt of the same colour. The occasional spring of dead grass serves to liven it up.

* * *

>up
Quite Far Up the Hill
Far enough up the hill to be out of breath if you don't get out much. Like the rest of the hill, this part is made entirely out of dirt.

>x boulder
That really is a lot of rock. It looks mercifully smaller from up here at least.

* * *

Let's Play: Ancient Greek Punishment: The Text Adventure
An Interactive Fiction by Pippin Barr
Release 1 / Serial number 190624 / Inform 7 build 6M62 (I6/v6.33 lib 6/12N) SD

Type HELP for help.

The Bank of the River Styx
Here you are on the gritty beach at the edge of the famous River Styx. The water flows sluggishly by.

You can see Charon's ferry and Charon here.

>walk
You'll have to say which compass direction to go in.

>go
You'll have to say which compass direction to go in.

>go north
You can't go that way.

>my name is zen
I didn't understand that sentence.

>my name is zeno
A Flat Beach (at the starting line)
The beach extends off into the fog. A straight running track of about 100 meters has been sketched into the sand leading north away from the river with the starting line closest to the water. In the distance at the end of the track, a limp green flag is visible. You are at the start line.

>walk
You'll have to say which compass direction to go in.

>walk south
You can run in all kinds of directions once you've finished the race. For now focus on getting to the flag, which is north of where you are now.

* * *

>walk north
You run furiously and cover half the distance to the flag!

A Flat Beach (on the track)
The beach extends off into the fog. A straight running track of about 100 meters has been sketched into the sand leading north away from the river with the starting line closest to the water. In the distance at the end of the track, a limp green flag is visible. You are at the start line.

>n
You run furiously and cover half the distance to the flag!

>restart
Are you sure you want to restart?

* * *

>y
Let's Play: Ancient Greek Punishment: The Text Adventure
An Interactive Fiction by Pippin Barr
Release 1 / Serial number 190611 / Inform 7 build 6M62 (I6/v6.33 lib 6/12N) SD

The Bank of the River Styx
Here you are at the famous River Styx. The water flows sluggishly by.

You can see Charon's ferry and Charon here.

>walk north
You can't go that way.

>walk
You'll have to say which compass direction to go in.

>my name is zeno
A Flat Beach (at the starting line)
The beach extends off into the fog. A straight running track of about 100 meters has been sketched into the sand leading north away from the river with the starting line closest to the water. In the distance at the end of the track, a limp green flag is visible. You are at the start line.

* * *

>walk
You'll have to say which compass direction to go in.

>walk charon
He's not something you can enter.

>my name is zeno
A Flat Beach (at the starting line)
The beach extends off into the fog. A straight running track of about 100 meters has been sketched into the sand leading north away from the river with the starting line closest to the water. In the distance at the end of the track, a limp green flag is visible. You are at the start line.

>s
You can run in all kinds of directions once you've finished the race. For now focus on getting to the flag, which is north of where you are now.

>walk s
Races are for running!

>walk
You'll have to say which compass direction to go in.

>walk east
Races are for running!

>walk north
Races are for running!

* * *

>go north
Races are for running!

>north
You run furiously and cover half the distance to the flag!

A Flat Beach (on the track)
The beach extends off into the fog. A straight running track of about 100 meters has been sketched into the sand leading north away from the river with the starting line closest to the water. In the distance at the end of the track, a limp green flag is visible. You are at the start line.

>run north
Races are for running!

>restart
Are you sure you want to restart?

* * *

>walk north
You can't go that way.

>walk east
You can't go that way.

>my name is sisyphus
Bottom of the Hill
A grey, gritty beach meets the edge of the river. A low, bare hill rises gently upward.

You can see a worryingly large boulder here.

>walk north
You can't go that way.

>walk up
A Little Way Up the Hill
Just above the beach the grit-sand turns into a packed dirt of the same colour. The occasional sprig of dead grass serves to liven it up.

* * *

Let's Play: Ancient Greek Punishment: The Text Adventure
An Interactive Fiction by Pippin Barr
Release 1 / Serial number 190624 / Inform 7 build 6M62 (I6/v6.33 lib 6/12N) SD

Type HELP for help.

The Bank of the River Styx
Here you are on the gritty beach at the edge of the famous River Styx. The water flows sluggishly by.

You can see Charon's ferry and Charon here.

>walk north
You can't go that way.

>my name is zeno
A Flat Beach (at the starting line)
The beach extends off into the fog. A straight running track of about 100 meters has been sketched into the sand leading north away from the river with the starting line closest to the water. In the distance at the end of the track, a limp green flag is visible. You are at the start line.

* * *

>walk south
You can run in all kinds of directions once you've finished the race. For now focus on getting to the flag, which is north of where you are now.

>walk north
Races are for running!

>l
A Flat Beach (at the starting line)
The beach extends off into the fog. A straight running track of about 100 meters has been sketched into the sand leading north away from the river with the starting line closest to the water. In the distance at the end of the track, a limp green flag is visible. You are at the start line.

>go north
You run furiously and cover half the distance to the flag!

A Flat Beach (on the track)
The beach extends off into the fog. A straight running track of about 100 meters has been sketched into the sand leading north away from the river with the starting line closest to the water. In the distance at the end of the track, a limp green flag is visible. You are at the start line.

>walk north walk
I only understood you as far as wanting to walk north.

>walk walk north
You can't see any such thing.

>walk north
Races are for running!

>run north
You run furiously and cover half the distance to the flag!

A Flat Beach (on the track)
The beach extends off into the fog. A straight running track of about 100 meters has been sketched into the sand leading north away from the river with the starting line closest to the water. In the distance at the end of the track, a limp green flag is visible. You are half-way to the flag.

* * *

Let's Play: Ancient Greek Punishment: The Text Adventure
An Interactive Fiction by Pippin Barr
Release 1 / Serial number 190624 / Inform 7 build 6M62 (I6/v6.33 lib 6/12N) SD

Type HELP for help.

The Bank of the River Styx
Here you are on the gritty beach at the edge of the famous River Styx. The water flows sluggishly by.

You can see Charon's ferry and Charon here.

>x beach
Apparently death is a beach, too. Not much of a beach day.

>sisyphus
Bottom of the Hill
A grey, gritty beach meets the edge of the river. A low, bare hill rises gently upward.

You can see a worryingly large boulder here.

>x beach
Apparently death is a beach too.

* * *

>x beach
Apparently death is a beach, too. Not much of a beach day.

>x sand
Apparently death is a beach, too. Not much of a beach day.

* * *

Let's Play: Ancient Greek Punishment: The Text Adventure
An Interactive Fiction by Pippin Barr
Release 1 / Serial number 190624 / Inform 7 build 6M62 (I6/v6.33 lib 6/12N) SD

Type HELP for help.

The Bank of the River Styx
Here you are on the gritty beach at the edge of the famous River Styx. The water flows sluggishly by.

You can see Charon's ferry and Charon here.

>x charon
Charon is one tall drink of stagnant water. His eyes look sourly out from beneath a cowl. He is holding a clipboard.

>open mouth
You open your mouth and neatly catch the small coin that drops out.

* * *

>x clipboard
Charon irritably angles the clipboard away from you, but not before you've seen the list of names he's expecting for the trip across the river:

Sisyphus
Tantalus
Prometheus
Danaids
Zeno

>x charon
Charon is one tall drink of stagnant water. His eyes look sourly out from beneath a cowl. He is holding a clipboard.

>talk to charon
Before you can get a word in, Charon monotones, "And you are?"

Recalling the list of names on the clipboard, you say:

Error: no text for Talk to Charon.

1) "I'm Sisyphus!"

2) "Never mind..." 
>

* * *

>x charon
Charon is one tall drink of stagnant water. His eyes look sourly out from beneath a cowl. He is sitting at the oars.

With a series of surprisingly muscular pulls on the oars, Charon sends the ferry across the river. You barely have time to take in the gloomy fog and lack of scenery before the prow of the boat grinds onto the rocky sand of a beach.

Charon looks at you implacably. You intuit that it's time for you to get out.

>x ferry
It's Charon's ferry, not totally unlike a small dinghy. Right now it is pulled up onto the bank of the river, ready to shove off into the river.

In Charon's ferry is Charon.

* * *

>x charon
Charon is one tall drink of stagnant water. His eyes look sourly out from beneath a cowl. He is holding a clipboard.

>x clipboard
Charon irritably angles the clipboard away from you, but not before you've seen the list of names he's expecting for the trip across the river:

Sisyphus
Tantalus
Prometheus
Danaids
Zeno

>talk to charon
You start trying to speak, but there's something in your mouth.

>open mouth
You open your mouth and neatly catch the small coin that drops out.

* * *

>x coin
(the obol)
A small silver coin imprinted with the blurry image of a sleepy man's face.

>talk to charon
Before you can get a word in, Charon monotones, "And you are?"

Recalling the list of names on the clipboard, you say:

1) "I'm Sisyphus!"

2) "I'm Tantalus!"

3) "I'm Prometheus!"

4) "I'm a Danaid!"

5) "I'm Zeno!"

6) "Never mind..." 
>

>restart
[Please answer by typing a number between 1 and 6.]
>

>y
[Please answer by typing a number between 1 and 6.]
>

>6
You shrug, "Never mind..."

Charon smirks.

>restart
Are you sure you want to restart?

* * *

>y
Let's Play: Ancient Greek Punishment: The Text Adventure
An Interactive Fiction by Pippin Barr
Release 1 / Serial number 190619 / Inform 7 build 6M62 (I6/v6.33 lib 6/12N) SD

The Bank of the River Styx
Here you are at the famous River Styx. The water flows sluggishly by.

You can see Charon's ferry and Charon here.

>open mouth
You open your mouth and neatly catch the small coin that drops out.

* * *

>talk to charon
Before you can get a word in, Charon monotones, "And you are?"

You realise you don't know and fall silent.

>x charon
Charon is one tall drink of stagnant water. His eyes look sourly out from beneath a cowl. He is holding a clipboard.

>look at charon
Charon is one tall drink of stagnant water. His eyes look sourly out from beneath a cowl. He is holding a clipboard.

>test sisyphus
(Testing.)

>[1] open mouth
It's open already, and you've never looked better.

>[2] x clipboard
Charon irritably angles the clipboard away from you, but not before you've seen the list of names he's expecting for the trip across the river:

Sisyphus
Tantalus
Prometheus
Danaids
Zeno

>[3] talk to charon
Before you can get a word in, Charon monotones, "And you are?"

Recalling the list of names on the clipboard, you say:

1) "I'm Sisyphus!"

2) "I'm Tantalus!"

3) "I'm Prometheus!"

4) "I'm a Danaid!"

5) "I'm Zeno!"

6) "Never mind..." 
>> [4] 1
Charon looks at you blankly, "Sure. Pay me.". 

He holds out a bony hand.

>[5] pay charon
You hand over the small coin. Charon drops it into a pocket and gestures at the ferry. You should probably get in.

>[6] get into boat
Charon sets about unmooring the ferry.

>[7] z
Time passes.

Charon steps deftly into the ferry and takes up his position at the oars.

>[8] z
Time passes.

With a series of surprisingly muscular pulls on the oars, Charon sends the ferry across the river. You barely have time to take in the gloomy fog and lack of scenery before the prow of the boat grinds onto the rocky sand of a beach.

Charon looks at you implacably. You intuit that it's time for you to get out.

>[9] get out
Before he departs, Charon mentions you can get to your punishment faster by just announcing yourself immediately, such as saying "My name is Sisyphus." His duty discharged, Charon oars away without giving you a another thought.

* * *

>x charon
Charon is one tall drink of stagnant water. His eyes look sourly out from beneath a cowl. He is holding a clipboard.

>x ferry
It's Charon's ferry, not totally unlike a small dinghy. Right now it is pulled up onto the bank of the river, ready to shove off into the river.

>test sisyphus
(Testing.)

>[1] open mouth
You open your mouth and neatly catch the small coin that drops out.

>[2] x clipboard
Charon irritably angles the clipboard away from you, but not before you've seen the list of names he's expecting for the trip across the river:

Sisyphus
Tantalus
Prometheus
Danaids
Zeno

>[3] talk to charon
Before you can get a word in, Charon monotones, "And you are?"

Recalling the list of names on the clipboard, you say:

Error: no text for Talk to Charon.

1) "I'm Sisyphus!"

2) "Never mind..." 
>> [4] 1
Charon raises his eyebrow, "Oh yeah? Sure thing. Give me the coin.". 

He holds out a bony hand.

>[5] pay charon
You hand over the small coin. Charon drops it into a pocket and gestures at the ferry. "Looks like we're in business. Get in."

>[6] get into boat
Charon is seemingly at pains not to help you step into the ferry. Once you're established, he climbs in after you.

Charon sets about unmooring the ferry.

>[7] z
Time passes.

Charon steps deftly into the ferry and takes up his position at the oars.

>[8] z
Time passes.

With a series of surprisingly muscular pulls on the oars, Charon sends the ferry across the river. You barely have time to take in the gloomy fog and lack of scenery before the prow of the boat grinds onto the rocky sand of a beach.

Charon looks at you implacably. You intuit that it's time for you to get out.

>[9] get out
You get out of Charon's ferry.

Bottom of the Hill
A grey, gritty beach meets the edge of the river. To the north a low, bare hill rises gently upward.

You can see Charon's ferry (in which is Charon) and a worryingly large boulder here.

>get into ferry
Charon narrows his eyes and it's enough to stop you in your tracks.

Charon oars away without giving you a second thought.

>l
Bottom of the Hill
A grey, gritty beach meets the edge of the river. To the north a low, bare hill rises gently upward.

You can see a worryingly large boulder here.

* * *

>x charon
Charon is one tall drink of stagnant water. His eyes look sourly out from beneath a cowl. He is holding a clipboard.

>x man
Charon is one tall drink of stagnant water. His eyes look sourly out from beneath a cowl. He is holding a clipboard.

>x river
You can't see any such thing.

* * *

Let's Play: Ancient Greek Punishment: The Text Adventure
An Interactive Fiction by Pippin Barr
Release 1 / Serial number 190624 / Inform 7 build 6M62 (I6/v6.33 lib 6/12N) SD

Type HELP for help.

The Bank of the River Styx
Here you are on the gritty beach at the edge of the famous River Styx. The water flows sluggishly by.

You can see Charon's ferry and Charon here.

>x clip
You can't see any such thing.

>x clipboard
Charon irritably angles the clipboard away from you, but not before you've seen the list of names he's expecting for the trip across the river.

-------
 Sisyphus
 Tantalus
 Prometheus
 Danaids
 Zeno
 -------

* * *

Let's Play: Ancient Greek Punishment: The Text Adventure
An Interactive Fiction by Pippin Barr
Release 1 / Serial number 190624 / Inform 7 build 6M62 (I6/v6.33 lib 6/12N) SD

Type HELP for help.

The Bank of the River Styx
Here you are on the gritty beach at the edge of the famous River Styx. The water flows sluggishly by.

You can see Charon's ferry and Charon here.

>x clipboard
Charon irritably angles the clipboard away from you, but not before you've seen the list of names he's expecting for the trip across the river:

Sisyphus
Tantalus
Prometheus
Danaids
Zeno

* * *

>open mouth
You open your mouth and neatly catch the small coin that drops out.

>talk to charon
Charon looks at you gloomily.

1) "Hi..." 
2) "Uh, bye..." 
>

>1
Charon sighs. "And you are...?".

1) "I'm... uh... Sisyphus!"

2) "Uh, bye..." 
>

>1
Charon raises his eyebrow, "Oh yeah? Sure thing. Give me the coin.". He gestures impatiently with a bony hand.

* * *

Let's Play: Ancient Greek Punishment: The Text Adventure
An Interactive Fiction by Pippin Barr
Release 1 / Serial number 190624 / Inform 7 build 6M62 (I6/v6.33 lib 6/12N) SD

Type HELP for help.

The Bank of the River Styx
Here you are on the gritty beach at the edge of the famous River Styx. The water flows sluggishly by.

You can see Charon's ferry and Charon here.

>x cowl
It's a standard-issue cowl.

>x charon's cowl
It's a standard-issue cowl.

>x charon
Charon is leaning against his ferry. His eyes look sourly out from beneath a cowl. He is holding a clipboard.

>x ferry
It's Charon's ferry, not totally unlike a small dinghy. Right now it is pulled up onto the bank of the river, ready to shove off into the river.

>swim
That's not a verb I recognise.

* * *

Let's Play: Ancient Greek Punishment: The Text Adventure
An Interactive Fiction by Pippin Barr
Release 1 / Serial number 190624 / Inform 7 build 6M62 (I6/v6.33 lib 6/12N) SD

Type HELP for help.

The Bank of the River Styx
Here you are on the gritty beach at the edge of the famous River Styx. The water flows sluggishly by.

You can see Charon's ferry and Charon here.

>x eagle
You can't see any such thing.

>i am prometheus
The Rock (chained to the rock)
Beneath what passes for daylight here, an unpleasantly jagged black rock rises from the ash colored sand of the beach. You are chained to said rock.

* * *

>x eagle
You can't see any such thing.

>x eagle
You can't see any such thing.

* * *

Let's Play: Ancient Greek Punishment: The Text Adventure
An Interactive Fiction by Pippin Barr
Release 1 / Serial number 190624 / Inform 7 build 6M62 (I6/v6.33 lib 6/12N) SD

Type HELP for help.

The Bank of the River Styx
Here you are on the gritty beach at the edge of the famous River Styx. The water flows sluggishly by.

You can see Charon's ferry and Charon here.

>x eyes
Unhappy.

>get eyes
That seems to be a part of Charon.

* * *

Let's Play: Ancient Greek Punishment: The Text Adventure
An Interactive Fiction by Pippin Barr
Release 1 / Serial number 190624 / Inform 7 build 6M62 (I6/v6.33 lib 6/12N) SD

Type HELP for help.

The Bank of the River Styx
Here you are on the gritty beach at the edge of the famous River Styx. The water flows sluggishly by.

You can see Charon's ferry and Charon here.

>x face
Only partially visible, but completely disdainful.

>spit
You spit a small coin into your hand.

>x face
Which do you mean, Charon's face or the coin face?

>x coin face
He looks like he's been through a lot.

>spit
Rude.

>show coin to charon
(the obol to Charon)
Charon deadpans, "Good for you."

>x fog
It makes you feel distinctly less happy.

* * *

Let's Play: Ancient Greek Punishment: The Text Adventure
An Interactive Fiction by Pippin Barr
Release 1 / Serial number 190624 / Inform 7 build 6M62 (I6/v6.33 lib 6/12N) SD

Type HELP for help.

The Bank of the River Styx
Here you are on the gritty beach at the edge of the famous River Styx. The water flows sluggishly by.

You can see Charon's ferry and Charon here.

>x ferry
It's Charon's ferry, not totally unlike a small dinghy. Right now it is moored at the bank of the river, its oars lying lengthwise along the bench seats, ready to shove off.

>x seats
The seats in the ferry don't look especially comfortable, but that seems about par for the course.

>sit
What do you want to sit on?

>seats
That's not something you can sit down on.

* * *

Let's Play: Ancient Greek Punishment: The Text Adventure
An Interactive Fiction by Pippin Barr
Release 1 / Serial number 190624 / Inform 7 build 6M62 (I6/v6.33 lib 6/12N) SD

Type HELP for help.

The Bank of the River Styx
Here you are on the gritty beach at the edge of the famous River Styx. The water flows sluggishly by.

You can see Charon's ferry and Charon here.

>x fog
It makes you feel distinctly less happy.

>get fog
You try to take some and it goes about as well as expected.

>push fog
Stop being so pushy!

>pull fog
Stop beign so pully!

>climb onto fog
You can't see any such thing.

>climb fog
Nah.

>get water
That's hardly portable.

>drink water
Your drinking days are over.

>climb water
Nah.

>xyzzy
Nothing happens. Magic isn't real.

>sisyphus
Bottom of the Hill
A grey, gritty beach meets the edge of the river. A low, bare hill rises gently upward.

You can see a worryingly large boulder here.

>x hill
It's a good, solid hill. It probably never gets depressed.

* * *

Let's Play: Ancient Greek Punishment: The Text Adventure
An Interactive Fiction by Pippin Barr
Release 1 / Serial number 190624 / Inform 7 build 6M62 (I6/v6.33 lib 6/12N) SD

Type HELP for help.

The Bank of the River Styx
Here you are on the gritty beach at the edge of the famous River Styx. The water flows sluggishly by.

You can see Charon's ferry and Charon here.

>x hand
Which do you mean, your hand or Charon's hand?

>x charon's hand
Bony.

>take hand
That seems to be a part of Charon.

* * *

>x hand
Which do you mean, your hand or Charon's hand?

>x my hand
Dead.

>x your hand
You can't see any such thing.

>x charon's hand
Bony.

* * *

>x hand
Which do you mean, your hand or Charon's hand?

>x your hand
You can't see any such thing.

* * *

Let's Play: Ancient Greek Punishment: The Text Adventure
An Interactive Fiction by Pippin Barr
Release 1 / Serial number 190624 / Inform 7 build 6M62 (I6/v6.33 lib 6/12N) SD

Type HELP for help.

The Bank of the River Styx
Here you are on the gritty beach at the edge of the famous River Styx. The water flows sluggishly by.

You can see Charon's ferry and Charon here.

>x hilly
You can't see any such thing.

>sisyphus
Bottom of the Hill
A grey, gritty beach meets the edge of the river. A low, bare hill rises gently upward.

You can see a worryingly large boulder here.

>x hilly
It's a good, solid hill. It probably never gets depressed.

>up
A Little Way Up the Hill
Just above the beach the grit-sand turns into a packed dirt of the same colour. The occasional spring of dead grass serves to liven it up.

>x hilly
It's a good, solid hill. It probably never gets depressed.

* * *

Let's Play: Ancient Greek Punishment: The Text Adventure
An Interactive Fiction by Pippin Barr
Release 1 / Serial number 190624 / Inform 7 build 6M62 (I6/v6.33 lib 6/12N) SD

Type HELP for help.

The Bank of the River Styx
Here you are on the gritty beach at the edge of the famous River Styx. The water flows sluggishly by.

You can see Charon's ferry and Charon here.

>x liver
You can't see your liver at the moment, your flesh is pleasingly intact over the top of it.

* * *

Let's Play: Ancient Greek Punishment: The Text Adventure
An Interactive Fiction by Pippin Barr
Release 1 / Serial number 190624 / Inform 7 build 6M62 (I6/v6.33 lib 6/12N) SD

Type HELP for help.

The Bank of the River Styx
Here you are on the gritty beach at the edge of the famous River Styx. The water flows sluggishly by.

You can see Charon's ferry and Charon here.

>x me
You look deader than you remember looking.

>talk to charon
You start trying to speak, but there's something in your mouth.

* * *

>x charon
Charon is one tall drink of stagnant water. His eyes look sourly out from beneath a cowl. He is holding a clipboard.

>talk to charon
Before you can get a word in, Charon monotones, "And you are?"

You realise you don't know and fall silent.

* * *

Let's Play: Ancient Greek Punishment: The Text Adventure
An Interactive Fiction by Pippin Barr
Release 1 / Serial number 190624 / Inform 7 build 6M62 (I6/v6.33 lib 6/12N) SD

Type HELP for help.

The Bank of the River Styx
Here you are on the gritty beach at the edge of the famous River Styx. The water flows sluggishly by.

You can see Charon's ferry and Charon here.

>x mouth
You purse your lips and can just make them out while staring strenuously downward. As you do, you feel something in your mouth.

* * *

>i
You are carrying:
  an obol

>x mouth
You purse your lips and can just make them out while staring strenuously downward. As you do, you feel something in your mouth.

>open mouth
You shouldn't just stand around with your mouth open, you know.

>close mouth
It isn't something you can close.

* * *

>open mouth
You open your mouth and neatly catch the small coin that drops out.

>open my mouth
It isn't something you can open.

>open your mouth
You can't see any such thing.

>x my mouth
You purse your lips and can just make them out while staring strenuously downward.

* * *

>open mouth
You open your mouth and neatly catch the small coin that drops out.

>x player's mouth
You purse your lips and can just make them out while staring strenuously downward.

>open player's mouth
It isn't something you can open.

* * *

Let's Play: Ancient Greek Punishment: The Text Adventure
An Interactive Fiction by Pippin Barr
Release 1 / Serial number 190624 / Inform 7 build 6M62 (I6/v6.33 lib 6/12N) SD

Type HELP for help.

The Bank of the River Styx
Here you are on the gritty beach at the edge of the famous River Styx. The water flows sluggishly by.

You can see Charon's ferry and Charon here.

>x oars
Oarn't you glad you looked?

>get oars
That seems to be a part of Charon's ferry.

>push oars
Nothing obvious happens.

>kill oars
Wrong game.

>x hand
Bony.

>x my mouth
You purse your lips and can just make them out while staring strenuously downward. As you do, you feel something in your mouth.

>x mouth
You purse your lips and can just make them out while staring strenuously downward. As you do, you feel something in your mouth.

* * *

>x oars
Oarn't you glad you looked?

>x ferry
It's Charon's ferry, not totally unlike a small dinghy. Right now it is moored at the bank of the river, ready to shove off.

* * *

Let's Play: Ancient Greek Punishment: The Text Adventure
An Interactive Fiction by Pippin Barr
Release 1 / Serial number 190624 / Inform 7 build 6M62 (I6/v6.33 lib 6/12N) SD

Type HELP for help.

The Bank of the River Styx
Here you are on the gritty beach at the edge of the famous River Styx. The water flows sluggishly by.

You can see Charon's ferry and Charon here.

>x obol
A small silver coin imprinted with the blurry image of a sleepy man's face.

>x obol
You see nothing special about the obol.

>x clipboard
A list of names Charon is expecting for the trip across the river.

>x charon
Charon is leaning against his ferry. His eyes look sourly out from beneath a cowl. He is holding a clipboard.

>l charon
Charon is leaning against his ferry. His eyes look sourly out from beneath a cowl. He is holding a clipboard.

>x obol
You see nothing special about the obol.

>x obol
You see nothing special about the obol.

>i
You are carrying:
  an obol

* * *

Let's Play: Ancient Greek Punishment: The Text Adventure
An Interactive Fiction by Pippin Barr
Release 1 / Serial number 190624 / Inform 7 build 6M62 (I6/v6.33 lib 6/12N) SD

Type HELP for help.

The Bank of the River Styx
Here you are on the gritty beach at the edge of the famous River Styx. The water flows sluggishly by.

You can see Charon's ferry and Charon here.

>x pocket
Looks roomy.

>look in pocket
Charon's pocket is empty.

* * *

Let's Play: Ancient Greek Punishment: The Text Adventure
An Interactive Fiction by Pippin Barr
Release 1 / Serial number 190624 / Inform 7 build 6M62 (I6/v6.33 lib 6/12N) SD

Type HELP for help.

The Bank of the River Styx
Here you are on the gritty beach at the edge of the famous River Styx. The water flows sluggishly by.

You can see Charon's ferry and Charon here.

>x river
The river seems to sneer at you.

>i am prometheus
The Rock (chained to the rock)
Beneath what passes for daylight here, an unpleasantly jagged black rock rises from the ash colored sand of the beach. You are chained to said rock.

>x river
The river seems to sneer at you.

An eagle appears on the horizon.

* * *

>x river
The river seems to sneer at you.

>sisyphus
Bottom of the Hill
A grey, gritty beach meets the edge of the river. A low, bare hill rises gently upward.

You can see a worryingly large boulder here.

>x river
The river seems to sneer at you.

>x water
The river seems to sneer at you.

>x sisyphus river
The river seems to sneer at you.

>x poop river
You can't see any such thing.

* * *

>x sneer
What an unpleasant river.

>drink river
Your drinking days are over.

* * *

Let's Play: Ancient Greek Punishment: The Text Adventure
An Interactive Fiction by Pippin Barr
Release 1 / Serial number 190624 / Inform 7 build 6M62 (I6/v6.33 lib 6/12N) SD

Type HELP for help.

The Bank of the River Styx
Here you are on the gritty beach at the edge of the famous River Styx. The water flows sluggishly by.

You can see Charon's ferry and Charon here.

>x seats
The seats don't look especially comfortable, but this is Hades.

* * *

Let's Play: Ancient Greek Punishment: The Text Adventure
An Interactive Fiction by Pippin Barr
Release 1 / Serial number 190624 / Inform 7 build 6M62 (I6/v6.33 lib 6/12N) SD

Type HELP for help.

The Bank of the River Styx
Here you are on the gritty beach at the edge of the famous River Styx. The water flows sluggishly by.

You can see Charon's ferry and Charon here.

>x sky
Gloomy and doomy.

>pay him
Charon looks at you wearily, "No paying until you tell me who you are." (Maybe you should talk to him first.)

>talk to charon
You start trying to speak, but there's something in your mouth. Perhaps you should spit it out.

>spit
You spit a small coin into your hand.

>x coin
(the obol)
A small silver coin imprinted with the blurry image of a sleepy man's face.

>talk to charon
Charon rolls his eyes. "Who are you, exactly?" He glances down at his clipboard. You realise you don't know.

>tantalus
You utter the magical words and the world seems to shudder on its axis, blurring everything for a moment. When you adjust your vision, your surroundings have changed.

A Desolate Beach (in the pool)
An apple tree extends its branches above a clear pool of water set back on the beach from the river's edge. A single apple hangs from a single branch.

Your stomach hurts with hunger.

>climb tree
You recoil from the incredibly sharp bark on the tree.

Your stomach hurts with hunger.

>get on tree
That's not something you can enter.

You wish you had something to drink.

>get up tree
I only understood you as far as wanting to get up.

>go up tree
I only understood you as far as wanting to go up.

>go up
You would have to get out of the pool first.

You wish you had something to drink.

>get out
Somehow that's not an option.

Your stomach gurgles.

>x bark
It's aggressive.

You need to eat something.

>prometheus
That particular magical incantation only works at the start of the game. Now that you're here, you're stuck here. If you want to get out so bad you can always restart or quit.

You're parched.

>restart
Are you sure you want to restart?

>y
Let's Play: Ancient Greek Punishment: The Text Adventure
An Interactive Fiction by Pippin Barr
Release 1 / Serial number 190621 / Inform 7 build 6M62 (I6/v6.33 lib 6/12N) SD

Type HELP for help.

The Bank of the River Styx
Here you are on the gritty beach at the edge of the famous River Styx. The water flows sluggishly by.

You can see Charon's ferry and Charon here.

>prometheus
You utter the magical words and the world seems to shudder on its axis, blurring everything for a moment. When you adjust your vision, your surroundings have changed.

The Rock (chained to the rock)
Beneath what passes for daylight here, an unpleasantly jagged black rock rises from the ash colored sand of the beach. You are chained to the rock. There is a yellow post-it note stuck just next to your head.

>x sun
A sun-coloured patch of fog.

An eagle appears on the horizon.

>read note
The note on the rock says

Wait.

Just after you finish reading it, the post-it note blows off the rock and away into the distance.

The eagle is getting close.

>wait
Time passes.

The eagle is right above you.

>wait
Time passes.

The eagle lands heavily beside you. You feel an urge to writhe.

>wait
Time passes.

The eagle eats some of your liver.

>strain
You strain in your chains desperately. It's enough to disturb the eagle, which flaps up into the air.

>kill eagle
You do understand you're chained to a rock, right?

The eagle lands heavily beside you. You feel an urge to twist.

>touch eagle
You do understand you're chained to a rock, right?

The eagle eats some of your liver.

>x fog
It makes you feel distinctly less happy.

The eagle eats some of your liver.

* * *

Let's Play: Ancient Greek Punishment: The Text Adventure
An Interactive Fiction by Pippin Barr
Release 1 / Serial number 190624 / Inform 7 build 6M62 (I6/v6.33 lib 6/12N) SD

Type HELP for help.

The Bank of the River Styx
Here you are on the gritty beach at the edge of the famous River Styx. The water flows sluggishly by.

You can see Charon's ferry and Charon here.

>x water
The river seems to sneer at you.

>i am sisyphus
Bottom of the Hill
A grey, gritty beach meets the edge of the river. A low, bare hill rises gently upward.

You can see a worryingly large boulder here.

>x water
bottom.

>x water
bottom.

>x river
bottom.

>x water
bottom.

>up
A Little Way Up the Hill
Just above the beach the grit-sand turns into a packed dirt of the same colour. The occasional sprig of dead grass serves to liven it up.

>x river
little.

* * *

Let's Play: Ancient Greek Punishment: The Text Adventure
An Interactive Fiction by Pippin Barr
Release 1 / Serial number 190624 / Inform 7 build 6M62 (I6/v6.33 lib 6/12N) SD

Type HELP for help.

The Bank of the River Styx
Here you are on the gritty beach at the edge of the famous River Styx. The water flows sluggishly by.

You can see Charon's ferry and Charon here.

>xyzzy
Nothing happens. Magic isn't real.

* * *

Let's Play: Ancient Greek Punishment: The Text Adventure
An Interactive Fiction by Pippin Barr
Release 1 / Serial number 190624 / Inform 7 build 6M62 (I6/v6.33 lib 6/12N) SD

Type HELP for help.

The Bank of the River Styx
Here you are on the gritty beach at the edge of the famous River Styx. The water flows sluggishly by.

You can see Charon's ferry and Charon here.

>z
Time passes.

>i am prometheus
The Rock (chained to the rock)
Beneath what passes for daylight here, an unpleasantly jagged black rock rises from the ash colored sand of the beach. You are chained to said rock.

* * *

Let's Play: Ancient Greek Punishment: The Text Adventure
An Interactive Fiction by Pippin Barr
Release 1 / Serial number 190624 / Inform 7 build 6M62 (I6/v6.33 lib 6/12N) SD

Type HELP for help.

The Bank of the River Styx
Here you are on the gritty beach at the edge of the famous River Styx. The water flows sluggishly by.

You can see Charon's ferry and Charon here.

>zeno
You utter the magical words and the world seems to shudder on its axis, blurring everything for a moment. When you adjust your vision, your surroundings have changed.

A Flat Beach (at the starting line)
The beach extends off into the fog. A straight track of about 100 meters has been sketched into the sand leading north away from the river with the starting line closest to the water. You can see a green flag in the distance at the end of the track. You are at the start line.

>run
You'll have to say which compass direction to go in.

>run north
You run furiously and cover half the distance to the flag!

A Flat Beach (on the track)
The beach extends off into the fog. A straight track of about 100 meters has been sketched into the sand leading north away from the river with the starting line closest to the water. You can see a green flag in the distance at the end of the track. You are half-way to the flag.

>walk north
Races are for running!

>l
A Flat Beach (on the track)
The beach extends off into the fog. A straight track of about 100 meters has been sketched into the sand leading north away from the river with the starting line closest to the water. You can see a green flag in the distance at the end of the track. You are half-way to the flag.

>run north
You run furiously and cover half the distance to the flag!

A Flat Beach (on the track)
The beach extends off into the fog. A straight track of about 100 meters has been sketched into the sand leading north away from the river with the starting line closest to the water. You can see a green flag in the distance at the end of the track. You are three-quarters of the way to the flag.