Let's Play: Ancient Greek Punishment: The Text Adventure
An Interactive Fiction by Pippin Barr
Release 1 / Serial number 190429 / Inform 7 build 6M62 (I6/v6.33 lib 6/12N) SD

Bank of the River Styx
You are standing on the bank of the River Styx. The water flows sluggishly by.

Charon is leaning against his ferry. His eyes look sourly out from beneath a cowl.

>get into ferry
You get into Charon's ferry.

* * *

Let's Play: Ancient Greek Punishment: The Text Adventure
An Interactive Fiction by Pippin Barr
Release 1 / Serial number 190429 / Inform 7 build 6M62 (I6/v6.33 lib 6/12N) SD

Bank of the River Styx
You are standing on the bank of the River Styx. The water flows sluggishly by.

Charon is leaning against his ferry. His eyes look sourly out from beneath a cowl.

>i
You are carrying:
  an obolus

* * *

Let's Play: Ancient Greek Punishment: The Text Adventure
An Interactive Fiction by Pippin Barr
Release 1 / Serial number 190429 / Inform 7 build 6M62 (I6/v6.33 lib 6/12N) SD

Bank of the River Styx
You are standing on the bank of the River Styx. The water flows sluggishly by.

Charon is leaning against his ferry. His eyes look sourly out from beneath a cowl.

>look
Example Location

* * *

Let's Play: Ancient Greek Punishment: The Text Adventure
An Interactive Fiction by Pippin Barr
Release 1 / Serial number 190429 / Inform 7 build 6M62 (I6/v6.33 lib 6/12N) SD

Bank of the River Styx
You are standing on the bank of the River Styx. The water flows sluggishly by.

Charon is leaning against his ferry. His eyes look sourly out from beneath a cowl.

>x charon
You see nothing special about Charon.

>x clipboard
You see nothing special about the clipboard.

* * *

Let's Play: Ancient Greek Punishment: The Text Adventure
An Interactive Fiction by Pippin Barr
Release 1 / Serial number 190429 / Inform 7 build 6M62 (I6/v6.33 lib 6/12N) SD

Bank of the River Styx
You are standing on the bank of the River Styx. The water flows sluggishly by.

Charon is leaning against his ferry. His eyes look sourly out from beneath a cowl.

>x ferry
Charon's ferry, not totally unlike a small dinghy, is pulled up onto the bank of the river, ready to shove off into the river.